hVD GTC	一代
hVD fDC	一共
hVD NTC	一再
hVD OMC	一切
hVD AcC	一半
hVD GAA	一同
hVD ipC	一向
hVD cJA	一如
hVD GvC	一定
hVD EOC	一帶
hVD GLC	一度
hVD IVL	一律
hVD Q1A	一心
hVD ayB	一手
hVD CqA	一旁
hVD EcC	一旦
hVD NkB	一早
hVD ZHA	一時
hVD eIC	一氣
hVD IyA	一流
hVD LwD	一直
hVD QfC	一線
hVD JGC	一致
hVD dJB	一舉
hVD AdA	一般
hVD eHB	一起
hVD aVA	一身
hVD IfA	一連
hVD AgA	一邊
hVD LVC	一陣
hVD DfC	一面
hVD GzA	一頭
hVD FMB	一體
hVD PMA	一齊
LpB AKA	丈夫
Q3A dED	三角
ZpB ITA	上來
ZpB eJC	上去
ZpC QHA	上司
ZpB LpA	上場
ZpB jED	上學
ZpC PxA	上層
ZpB VeA	上山
ZpB gcC	上岸
ZpB ZHB	上市
ZpC IyA	上流
ZpC lyA	上游
ZpB AdA	上班
ZpC eAA	上空
ZpC ExB	上等
ZpC d1H	上級
ZpC hIA	上衣
ZpB elK	上課
ZpC aVA	上身
ZpC AgA	上邊
ZpB DaA	上門
ZpB LVC	上陣
ZpC DfC	上面
ZpB DnB	上馬
jnB PxA	下層
jnB ZDD	下屬
jnB AnA	下巴
jnB RVI	下旬
jnB aVA	下身
jnB PTC	下載
jnB AgA	下邊
jnB DfC	下面
AXD d1E	不禁
AXD hiC	不要
AXD OqD	不錯
eyA IwA	丘陵
ZwA QpC	丞相
CvB CQA	並排
CvB jrA	並行
CvB NVC	並進
hnA GzA	丫頭
JBA dgA	中堅
JBA LpA	中場
JBA HgA	中年
JBA lDA	中庸
JBA Q1A	中心/忠心
JBA QuC	中性
JBA IyA	中流
JBA LuA	中程
JBA I1D	中立
JBA ExB	中等
JBC exB	中肯
JBA SpA	中裝
JBA GLA	中途
JBA BDA	中鋒
XKB cVA	主人
XKB IwD	主力
XKB GAB	主動
XKB LpA	主場
XKB CyB	主婦
XKB NTB	主宰
XKB GkC	主導
XKB RuD	主席
XKB LKA	主廚
XKB hHC	主意
XKB LHA	主持
XKB djC	主教
XKB XGB	主旨
XKB ffM	主權
XKB IyA	主流
XKB lfB	主演
XKB dcJ	主管
XKB gFG	主義
XKB hiC	主要
XKB dEB	主講
XKB CeC	主辦
XKB FMB	主體
HTB XGC	乃至
dyB kII	久違
XHA PgA	之前
C9D IwD	乏力
C9D DIC	乏味
eYD dOC	乞丐
loB iJB	也許
cKB GqA	乳糖
cKB JJA	乳豬
cKB IqD	乳酪
ffE eaI	乾坤
dcA DnA	乾媽
dcA jcB	乾旱
dcA jqD	乾涸
dcA PuB	乾淨
dcA QkB	乾燥
dcA EoA	乾爹
dcA VpB	乾爽
dcA ONK	乾脆
dcA ilK	乾貨
IcK IVI	亂倫
IhB dgD	了結
cGC ayB	二手
cGC jLA	二胡
jLC IGC	互利
jLC UJC	互助
jLC GAB	互動
jLC jMK	互惠
jLC jcK	互換
jLC ALB	互補
jLC BpC	互訪
djA AKC	交付
djA GTC	交代
djA kpJ	交往
djA GTB	交待
djA N4D	交接
djA jcK	交換
djA luD	交易
djA FMC	交替
djA IyA	交流
djA dQC	交界
djA lBA	交融
djA G3A	交談
djA FAA	交通
djA BDA	交鋒
djA NNC	交際
dsA fsD	京劇
dsA ZuA	京城
dsA VGA	京師
IpC QpC	亮相
cVA JBA	人中
cVA IwD	人力
cVA ezB	人口
cVA DuQ	人名
cVA kXI	人員
cVA dVI	人均
cVA UHB	人士
cVA dnA	人家
cVA dAA	人工
cVA Q1A	人心
cVA QuC	人性
cVA PuA	人情
cVA PTA	人才
cVA DXA	人文
cVA ffM	人權
cVA OGC	人次
cVA DVA	人民
cVA eIC	人氣
cVA IyA	人流
cVA LiA	人潮
cVA hgA	人煙
cVA DXD	人物
cVA VsA	人生
cVA XDB	人種
cVA lfI	人緣
cVA aVA	人身
cVA deC	人間
cVA NNC	人際
cVA IGK	人類
cVA FMB	人體
Z1D d1F	什錦
cVA hTC	仁愛
fyA cVA	仇人
fyA jbC	仇恨
d1E FgA	今天
d1E HgA	今年
d1E cVD	今日
dQC c1D	介入
dQC hHC	介意
dQC ZiB	介紹
cwA cfA	仍然
cwA fyC	仍舊
FlA cVA	他人
AKC ecJ	付款
QfA EcA	仙丹
QfA dsB	仙境
QfA NHB	仙子
GTC dnC	代價
GTC FMC	代替
GTC IHB	代理
GTC AiF	代表
GTC elK	代課
GTC RoC	代謝
lHB ITA	以來
lHB DfF	以免
lHB PgA	以前
lHB f1H	以及
lHB gOK	以外
lHB kpJ	以往
lHB fHA	以期
lHB kFI	以爲
lHB XGC	以至
lHB JGC	以致
BpB XiC	仿照
BpB XNC	仿製
iyA dnC	休假
iyA QwD	休息
iyA eNG	休憩
iyA jOK	休會
iyA deA	休閒
ArD ArD	伯伯
dLB dnC	估價/股價
dLB QcJ	估算
dLB dMC	估計
IvA cVA	伶人
IvA EvA	伶仃
aVA JfB	伸展
aVA ayB	伸手/身手
RHB jLA	似乎
RHB EvD	似的
LJB I1D	佇立
ALC fDD	佈局
ALC dsB	佈景
ALC JHC	佈置
kGK JHC	位置
EMA dLB	低估
EMA I4A	低廉
EMA L1A	低沉
EMA haI	低溫
EMA LiA	低潮
EMA hnI	低窪
EMA d1H	低級
EMA IqD	低落
EMA DMA	低迷
EMA h1E	低音
EMA GzA	低頭
LKC QBD	住宿
LKC CpA	住房
LKC VJB	住所
NlC NyB	佐酒
E5A dJC	佔據
E5A kyB	佔有
E5A lDC	佔用
E5A IuB	佔領
CXD RpB	佛像
CXD jED	佛學
CXD RHC	佛寺
CXD djC	佛教
CXD NLB	佛祖
CXD GlA	佛陀
NqD kFI	作爲
CSC ETC	佩戴
CSC CBD	佩服
dPA NgD	佳節
VHB lDC	使用
VHC dcK	使館
ITA QVC	來信
ITA aNC	來勢
ITA jSI	來回
ITA kpJ	來往
ITA gZI	來源
INC gOK	例外
INC NHB	例子
INC XwC	例證
ZHC CDB	侍奉
ZHC XoB	侍者
dDA CDB	供奉
hIA hSI	依偎
hIA PaI	依存
hIA RVI	依循
hIA IfK	依戀
hIA dJC	依據
hIA OGC	依次
hIA A9D	依法
hIA cfA	依然
hIA XiC	依照
hIA iIA	依稀
hIA fyC	依舊
hIA IOC	依賴
hIA CKC	依附
hIA ekC	依靠
DKB cDD	侮辱
O1A E5A	侵佔
O1A c1D	侵入
O1A ciB	侵擾
O1A ffM	侵權
O1A C9B	侵犯
O1A IpD	侵略
O1A bwD	侵蝕
ODD VHB	促使
ODD ZuA	促成
ODD NVC	促進
ODD QiA	促銷
RDD DuQ	俗名
BKA ILB	俘虜
AkB kyC	保佑
AkB PaI	保存
AkB hcA	保安
AkB DVH	保密
AkB LHA	保持
AkB HcJ	保暖
AkB AaB	保本
AkB aNK	保稅
AkB dcJ	保管
AkB lBD	保育
AkB XwC	保證
AkB jLC	保護
AkB auD	保釋
AkB i4F	保險
j5D gFG	俠義/協議
QVC j6A	信函
QVC CDB	信奉
QVC GLA	信徒
QVC Q1A	信心
QVC H5C	信念
QVC QwD	信息/訊息
QVC CBD	信服
QVC DXD	信物
QVC lDC	信用
QVC QpA	信箱
QVC FqD	信託
QVC FTC	信貸
QyA NfB	修剪
QyA UHB	修士
QyA dZC	修建
QyA dTB	修改
QyA g8D	修業
QyA IHB	修理
QyA ZfC	修繕
QyA R1D	修習
QyA ALB	修補
QyA aVA	修身
QyA RHA	修辭
QyA awD	修飾
AKB e3C	俯瞰
AKB aVA	俯身
dKA PfI	俱全
OqA eLC	倉庫
dlC cVA	個人
dlC CfH	個別
dlC QuC	個性
dlC hcC	個案
dlC FMB	個體
EkC VKB	倒數
EkC VKC	倒數
fXL fpA	倔強
IVI IHB	倫理
LwD ExD	值得
LHC ExD	值得
LwD PfA	值錢
dnB VHB	假使
dnC cVD	假日
BfA BfA	偏偏
BfA ipC	偏向
BfA X1D	偏執
BfA ikC	偏好
BfA hTC	偏愛
BfA dvD	偏激
GvA dAA	停工
GvA dIA	停機
GvA iZD	停歇
GvA XHB	停止
GvA LNC	停滯
GvA J6C	停站
GvA XwD	停職
GvA elK	停課
GvA YoA	停車
GvA ekC	停靠
GvA EaK	停頓
fZC PfI	健全
fZC SpC	健壯
fZC eqA	健康
fZC ZuD	健碩
fZC aVA	健身
SwD DBD	側目
SwD DfC	側面
FzA FzA	偷偷
FzA IcB	偷懶
FzA GLC	偷渡
FzA R1D	偷襲
FzA deA	偷閒
CqC DZB	傍晚
CGG AVE	備份
CGG XfC	備戰
CGG hcC	備案
CGG lDC	備用
OSI ODD	催促
OSI inK	催化
OSI IGK	催淚
OSI DgA	催眠
gkC DdC	傲慢
LfI ZwA	傳承
LfI djC	傳教
LfI FCC	傳統
LfI afL	傳說
euY ipC	傾向
euY DLC	傾慕
euY CaA	傾盆
euY QLC	傾訴
euY G3A	傾談
euY heD	傾軋
euY QiA	傾銷
dpA inK	僵化
dpA LHA	僵持
dpA gtC	僵硬
dnC LHC	價值
dnC DBD	價目
dnC DnB	價碼
dnC PfA	價錢
gFE eGG	儀器
gFE lDA	儀容
gFE awD	儀式
gFE AiF	儀表
cKA jED	儒學
cKA dnA	儒家
cKA gnB	儒雅
hyA IfL	優劣
hyA aNC	優勢
hyA inK	優化
hyA jMK	優惠
hyA lHC	優異
hyA QyC	優秀
hyA DGF	優美
hyA IpA	優良
hyA gnB	優雅
hyA E5B	優點
LJA CGG	儲備
LJA PaI	儲存
LJA KBD	儲蓄
LJA PqA	儲藏
g8B cfA	儼然
lVJ iJB	允許
lVJ HqD	允諾
gZI QiA	元宵
gZI EcC	元旦
gZI QLC	元素
gZI IkB	元老
YBA dAA	充公
YBA CXC	充分
YBA bVD	充實
YBA YuD	充斥
YBA DcB	充滿
YBA lKC	充裕
YBA GgC	充電
YBA dGE	充飢
LiB GzA	兆頭
dqI IpC	光亮
dqI OTB	光彩
dqI hsB	光影
dqI ksI	光榮
dqI XiC	光照
dqI QfC	光線
dqI I3C	光纜
dqI iII	光輝
dqI dLC	光顧
exD XNC	克制
exD CBD	克服
DfF ExD	免得
DfF luL	免疫
DfF aNK	免稅
DfF XwD	免職
cFA inK	兒化
cFA NHB	兒子
cFA dlA	兒歌
cFA elI	兒科
cFA GAA	兒童
FLC NHB	兔子
EzA ZyC	兜售
c1D gLB	入伍
c1D O1A	入侵
c1D ezB	入口
c1D dsB	入境
c1D loC	入夜
c1D jED	入學
c1D PlK	入座
c1D ayB	入手
c1D ZFK	入睡
c1D dLB	入股
c1D DaA	入門
PfI IwD	全力
PfI fDD	全局
PfI DXA	全文
PfI QVA	全新
PfI DVA	全民
PfI cfA	全然
PfI fyA	全球
PfI CcA	全盤
PfI LuA	全程
PfI XwD	全職
PfI DjC	全貌
PfI aVA	全身
PfI ELA	全都
PfI DfC	全面
PfI FMB	全體
AeD dPK	八卦
AeD PHC	八字
AeD ZuA	八成
dAA XKB	公主
dAA ALC	公佈
dAA gZI	公元
dAA dAA	公公
dAA fDC	公共
dAA DKC	公務
dAA awA	公升
dAA QHA	公司
dAA kZI	公園
dAA hcA	公安
dAA gKC	公寓
dAA dcC	公幹
dAA THC	公廁
dAA awD	公式
dAA hsC	公映
dAA jOK	公會
dAA kyB	公有
dAA XuC	公正
dAA DVA	公民
dAA A9D	公法
dAA lfB	公演
dAA luI	公營
dAA NpD	公爵
dAA IHB	公理
dAA huT	公益
dAA ZoB	公社
dAA QGA	公私
dAA I1D	公立
dAA XwD	公職
dAA XwC	公證
dAA ILC	公路
dAA eTA	公開
fDC GAA	共同
AsA IwD	兵力
AsA eGG	兵器
AsA GcI	兵團
fKC CGG	具備
fKC kyB	具有
fKC FMB	具體
EgB jvA	典型
EgB dLC	典故
EgB EqC	典當
EgB IMB	典禮
EgB C9B	典範
EgB PuD	典籍
EgB gnB	典雅
NTC jOK	再會
NTC jgC	再現
NTC VsA	再生
NTC XoB	再者
NTC dgC	再見
dcK dXI	冠軍
hZI dnA	冤家
DvA QpB	冥想
ECA FgA	冬天
ECA dGK	冬季
ECA dnI	冬瓜
ECA XGC	冬至
AwA eSK	冰塊
AwA VeA	冰山
AwA YfI	冰川
AwA QpA	冰箱
AwA GqA	冰糖
AwA QfL	冰雪
AwA CED	冰雹
loB d1E	冶金
XVJ iJB	准許
EhA RoC	凋謝
IwA IcK	凌亂
IwA dnC	凌駕
I1B IfD	凜冽
C9A ZFB	凡是
C9A deC	凡間
iDA LiB	凶兆
h6D j6C	凹陷
YVL VHC	出使
YVL AZD	出發
EkA fKC	刀具
EkA BDA	刀鋒
CXC NHB	分子
AXA NHB	分子
AXA jqA	分行
OgD dcD	切割
OMC bVD	切實
ecA DXD	刊物
ecA ExA	刊登
jvA fHA	刑期
jvA A9D	刑法
jvA CZD	刑罰
jvA dsB	刑警
IfD AiF	列表
TJA JBA	初中
TJA ECA	初冬
TJA loC	初夜
TJA IfK	初戀
TJA fHA	初期
TJA CLC	初步
TJA OyA	初秋
TJA d1H	初級
TJA QTC	初賽
BcC jvA	判刑
BcC GvC	判定
BcC EcK	判斷
CfH cVA	別人
CfH DuQ	別名
CfH ZJB	別墅
CfH PHC	別字
CfH JGC	別致
IGC eGG	利器
IGC jOC	利害
IGC QwD	利息
IGC cVK	利潤
IGC lDC	利用
IGC huT	利益
IGC IqD	利落
VdA d6B	刪減
EkC kGK	到位
EkC ITA	到來
EkC LpA	到場
EkC EMB	到底
EkC BpC	到訪
XNC CBD	制服
XNC XHB	制止
XNC jrA	制衡
OFC VeD	刺殺
exD hHC	刻意
exD AdB	刻板
FMC EkA	剃刀
QpD cpD	削弱
exD QvA	剋星
PgA cVA	前人
PgA RuD	前夕
PgA FgA	前天
PgA NzC	前奏
PgA kpJ	前往
PgA cVD	前日
PgA dsB	前景
PgA fHA	前期
PgA X4A	前瞻
PgA EcI	前端
PgA QfC	前線
PgA XoB	前者
PgA gZA	前言
PgA GLA	前途
PgA NVC	前進
PgA AgA	前邊
PgA BDA	前鋒
PgA DfC	前面
PgA GzA	前頭
dqA duS	剛勁
NfB AkC	剪報
NfB hsB	剪影
NfB N4D	剪接
NfB P1D	剪輯
dcD IfD	割裂
dcD cpC	割讓
jtL hVD	劃一
fsD GcI	劇團
fsD LpA	劇場
fsD GcA	劇壇
fsD PuA	劇情
fsD AaB	劇本
fsD IfD	劇烈
fsD XiC	劇照
IwD GLA	力圖
IwD jED	力學
IwD NlK	力挫
IwD eIC	力氣
IwD fyA	力求
IwD StA	力爭
dAA IGC	功利
dAA IwD	功力
dAA jjC	功效
dAA lDC	功用
dAA elK	功課
dnA lHB	加以
dnA CSB	加倍
dnA c1D	加入
dnA fsD	加劇
dnA dAA	加工
dnA fpA	加強
dnA eRK	加快
dnA lyA	加油
dnA a1A	加深
dnA cfD	加熱
dnA DnB	加碼
dnA dVB	加緊
dnA QVA	加薪
dnA QAD	加速
UJC ayB	助手
UJC IHB	助理
HLB IwD	努力
duS GvD	勁敵
duS IJB	勁旅
lDB d3B	勇敢
lDB eIC	勇氣
DfF fpA	勉強
GAB cVA	動人
GAB IwD	動力
GAB kXI	動員
GAB lDA	動容
GAB dAA	動工
GAB d2B	動感
GAB FTC	動態
GAB ayB	動手
GAB liA	動搖
GAB dIA	動機
GAB DXD	動物
GAB lDC	動用
GAB RHA	動詞
GAB gFG	動議
GAB J4D	動輒
GAB PuB	動靜
e2C TeD	勘察
e2C F2A	勘探
e2C TwD	勘測
DKC bVD	務實
awA c1C	勝任
awC IGC	勝利
awC GGC	勝地
DLC lfI	募捐
DLC P1D	募集
aNC IwD	勢力
aNC AVD	勢必
aNC GzA	勢頭
fYA DfF	勤勉
fYA eRK	勤快
INC XHC	勵志
eZK DfF	勸勉
AjA j2A	包含
AjA lDA	包容
AjA dcL	包括
AjA dIA	包機
AjA SeD	包紮
AjA SpA	包裝
AjA QiA	包銷
inK jED	化學
inK dAA	化工
inK ZuD	化石
inK aVA	化身
inK g4G	化驗
AxD fwD	北極
AxD AgA	北邊
fGO C9D	匱乏
BVD BSC	匹配
AgB grD	匾額
MwD DuQ	匿名
eKA AfH	區別
OgA dLB	千古
OgA DZC	千萬
OgA d1E	千金
awA fHA	升旗
awA haI	升溫
awA d1H	升級
awA XwD	升職
gLB ZFK	午睡
gLB OcA	午餐
AcC dnC	半價
AcC loC	半夜
AcC FgA	半天
AcC QGB	半死
AcC GLA	半途
AcC AgA	半邊
AFA IfL	卑劣
AFA DIA	卑微
AFA PfC	卑賤
j5D IwD	協力
j5D UJC	協助
j5D GAA	協同
j5D apA	協商
j5D GvC	協定
j5D jOK	協會
j5D CeC	協辦
H2A AxD	南北
H2A fwD	南極
H2A dnI	南瓜
AqD UHB	博士
AqD luD	博弈
AqD hTC	博愛
X4A AAD	占卜
hVC AZD	印發
hVC XpA	印章
hVC inI	印花
hVC XNC	印製
hVC XwC	印證
hVC RpB	印象
gFM f1H	危及
gFM jOC	危害
gFM d1H	危急
gFM dIA	危機
gFM GTB	危殆
gFM i4F	危險
NwD VHB	即使
NwD exD	即刻
NwD RuD	即席
NwD cVD	即日
NwD ZHA	即時
epD CLC	卻步
gZI ITA	原來
gZI NxD	原則
gZI hVA	原因
gZI aHB	原始
gZI NHB	原子
gZI AaB	原本
gZI IHB	原理
gZI PuD	原籍
gZI IpC	原諒
gZI DjC	原貌
h4C hLC	厭惡
INC jOC	厲害
T1A TFA	參差
O2A lJC	參與
O2A dcI	參觀
f1H NkB	及早
f1H ZHA	及時
f1H GMC	及第
f1H XGC	及至
kyB cVA	友人
kyB ZfB	友善
kyB hTC	友愛
kyB gFG	友誼
AZB hwC	反應
AZB BBD	反覆
aBD aBD	叔叔
ZyB XNC	受制
ZyB eaK	受困
ZyB lwC	受孕
ZyB jOC	受害
ZyB a1B	受審
ZyB jMK	受惠
ZyB NlK	受挫
ZyB QaJ	受損
ZyB cfD	受熱
ZyB lDC	受用
ZyB huT	受益
ZyB BuS	受聘
ZyB gpD	受虐
ZyB iXK	受訓
ZyB FqD	受託
ZyB BpC	受訪
ZyB iSJ	受賄
CcC IcK	叛亂
CcC gsD	叛逆
PAA I1A	叢林
ezB DXB	口吻
ezB DIC	口味
ezB gcC	口岸
ezB d2B	口感
ezB aGJ	口水
ezB f1E	口琴
ezB AFE	口碑
ezB ABD	口福/口腹
ezB jAA	口紅
ezB JjC	口罩
ezB eEA	口腔
ezB GTC	口袋
ezB dED	口角
ezB dgL	口訣
ezB bVL	口述
ezB h1E	口音
ezB GzA	口頭/叩頭
dLB cVA	古人
dLB GTC	古代
dLB EgB	古典
dLB F3D	古塔
dLB DLC	古墓
dLB AdB	古板
dLB DXD	古物
dLB gcK	古玩
dLB f1E	古琴
dLB StA	古箏
dLB PuD	古籍
dLB IkB	古老
dLB fyC	古舊
dLB EAB	古董
dLB SpA	古裝
dLB aHA	古詩
dLB NuD	古蹟
LiC icK	召喚
LiC eTA	召開
LiC P1D	召集
elB cVA	可人
elB lHB	可以
elB QVC	可信
elB ezB	可口
elB AGE	可悲
elB QuD	可惜
elB hTC	可愛
elB IgA	可憐
elB ZFB	可是
elB gHA	可疑
elB kIK	可謂
elB ekC	可靠
VHB PgA	史前
VHB jED	史學
VHB bVD	史實
VHB PuD	史籍
QHA gFE	司儀
QHA dIA	司機
QHA A9D	司法
dqD dlC	各個
dqD PGC	各自
dVD IGC	吉利
dVD RpA	吉祥
GAA hVD	同一
GAA inK	同化
GAA jED	同學
GAA HgA	同年/童年
GAA XHC	同志
GAA QuC	同性
GAA PuA	同情
GAA hHC	同意
GAA ZHA	同時
GAA fHA	同期
GAA g8D	同業
GAA CLC	同步
GAA ExB	同等
GAA ipA	同鄉
GAA IGK	同類
DuQ cVA	名人
DuQ TtD	名冊
DuQ IGC	名利
DuQ awC	名勝
DuQ ZuA	名城
DuQ GqA	名堂
DuQ PHC	名字
DuQ dnA	名家
DuQ VeA	名山
DuQ VGA	名師
DuQ IyA	名流
DuQ BgC	名片
DuQ gFG	名義
DuQ RHA	名詞
DuQ grD	名額
dXI XKB	君主
dXI NHB	君子
IVC VwD	吝嗇
j2A hHC	含意
j2A gFG	含義
i1H lVB	吸引
i1H dcJ	吸管
i1H H2D	吸納
i1H CKC	吸附
MGA M6A	呢喃
XyA PfI	周全
XyA jOK	周會
XyA lyA	周遊
DIC NuA	味精
DIC GkB	味道
iLA i1H	呼吸
iLA icK	呼喚
iLA dyC	呼救
iLA lKC	呼籲
DsC IuC	命令
DsC DuQ	命名
DsC hcC	命案
DsC kXK	命運
CjA ijA	咆哮
NGA QVI	咨詢
XFB YuD	咫尺
hgA jzA	咽喉
hTA UyA	哀愁
B1F DIC	品味
B1F ZpA	品嘗
B1F ExD	品德
B1F QuC	品性
B1F IGK	品類
kXI dAA	員工
dlA dlA	哥哥
eAD e1H	哭泣
eAD QLC	哭訴
ijA YfJ	哮喘
JfD jED	哲學
JfD IHB	哲理
CLC cKB	哺乳
drB hgD	哽咽
GqA IzA	唐樓
GqA GaL	唐突
ZyC dnC	售價
ZyC evC	售罄
ZyC DPC	售賣
YpC dAA	唱功
YpC eDD	唱曲
YpC dIA	唱機
YpC dlA	唱歌
YpC BgC	唱片
YpC eEA	唱腔
FlK DcD	唾沫
apA cVA	商人
apA DKC	商務
apA B1F	商品
apA LpA	商場
apA dnA	商家
apA E5C	商店
apA IJB	商旅
apA jOK	商會
apA g8D	商業
apA dIA	商機
apA dQC	商界
apA bfI	商船
apA G3A	商談
apA AZC	商販
apA DzC	商貿
DXC EvB	問鼎
ZfB Q1A	善心
ZfB AaB	善本
ZfB ecJ	善款
ZfB IpA	善良
jzA IAA	喉嚨
jzA GzA	喉頭
YfJ QwD	喘息
icK eHB	喚起
iHB fsD	喜劇
iHB ikC	喜好
iHB hgC	喜宴
iHB lfL	喜悅
iHB hTC	喜愛
iHB esC	喜慶
iHB icI	喜歡
EcA GhC	單調
PkA P2D	嘈雜
dnA iJB	嘉許
ZpA aHC	嘗試
KjA FkA	嘮叨
JjA ABC	嘲諷
hLC Q1A	噁心
eGG dcI	器官
eGG PTA	器材
eGG DsB	器皿
g8A INC	嚴厲
g8A DVH	嚴密
g8A jcA	嚴寒
g8A QVK	嚴峻
g8A LwA	嚴懲
g8A QBD	嚴肅
g8A jlA	嚴苛
g8A dYB	嚴謹
HqA dcL	囊括
RyA C9B	囚犯
QGC XyA	四周
QGC dGK	四季
QGC ZHA	四時
QGC XFA	四肢
QGC DfC	四面
jSI ITA	回來
jSI awA	回升
jSI DIC	回味
jSI AkC	回報
jSI hwD	回憶
jSI HcJ	回暖
jSI dII	回歸
jSI IyA	回流
jSI LuA	回程
jSI E2D	回答
jSI IqD	回落
jSI ipB	回響
jSI GzA	回頭
jSI dLC	回顧
jSI fGO	回饋
hVA RVI	因循
hVA dlJ	因果
hVA OFB	因此
hVA kFK	因爲
hVA lyA	因由
hVA QLC	因素
hVA lfI	因緣/姻緣
hVA cHA	因而
eaK dsB	困境
eaK jxL	困惑
eaK ciB	困擾
eaK fVN	困窘
eaK EaK	困頓
dLC X1D	固執
dLC GvC	固定
dLC FTC	固態
dLC kyB	固有
dLC cfA	固然
dLC FMB	固體
dxL DKC	國務
dxL dsB	國境
dxL jED	國學
dxL dnA	國家
dxL AkB	國寶
dxL eLC	國庫
dxL PuA	國情
dxL esC	國慶
dxL jOK	國會
dxL kyB	國有
dxL dlA	國歌
dxL DVA	國民
dxL luI	國營
dxL dQC	國界
dxL I1D	國立
dxL PuD	國籍
dxL QGK	國粹
dxL GkB	國道
dxL NNC	國際
kZI GGC	園地
kZI gNC	園藝
kfI jvA	圓形
kfI DcB	圓滿
kfI cVK	圓潤
kfI CcA	圓盤
GLA jvA	圖形
GLA aJA	圖書
GLA hcC	圖案
GLA BgC	圖片
GLA XpA	圖章
GLA XFB	圖紙
GLA GxA	圖騰
GcI kXI	團員
GcI kfI	團圓
GcI dgD	團結
GcI GSK	團隊
GcI FMB	團體
FLB LpD	土著
GGC XKB	地主
GGC kGK	地位
GGC aNC	地勢
GGC fYA	地勤
GGC DuQ	地名
GGC GLA	地圖
GGC XHB	地址
GGC kwL	地域
GGC dHA	地基
GGC PxA	地層
GGC EOC	地帶
GGC jvA	地形
GGC XFA	地支
GGC AdB	地板
GGC CLC	地步
GGC GcK	地段
GGC F3B	地毯
GGC gDD	地獄
GGC fyA	地球
GGC IHB	地理
GGC CFE	地皮
GGC CcA	地盤
GGC NLA	地租
GGC AiF	地表
GGC DjC	地貌
GGC GkB	地道
GGC FgD	地鐵
GGC XVC	地震
GGC DfC	地面
GGC E5B	地點
dVI lVI	均勻
dVI jrA	均衡
erA cVA	坑人
FcB exD	坦克
FcB ZwA	坦承
FcB cfA	坦然
FcB gZA	坦言
FcB ZuA	坦誠
ZFI QGB	垂死
ZFI IGK	垂淚
ZFI LwD	垂直
ZFI IkB	垂老
ZFI EhC	垂釣
DQA NqC	埋葬
ZuA AkB	城堡
ZuA ZHB	城市
ZuA PpA	城牆
ZuA ipA	城鄉
ZuA DaA	城門
X1D GkC	執導
X1D XpB	執掌
X1D g8D	執業
X1D XiC	執照
X1D AVH	執筆
dHA hVA	基因
dHA GGC	基地
dHA PxA	基層
dHA dZC	基建
dHA AaB	基本
dHA ZuD	基石
dHA TJB	基礎
dHA d1E	基金
dHA E5B	基點
GqA isI	堂兄
GqA DSC	堂妹
GqA NoB	堂姐
GqA jqI	堂皇
dgA dLC	堅固
dgA GvC	堅定
dgA bVD	堅實
dgA fpA	堅強
dgA cVB	堅忍
dgA LHA	堅持
dgA gIC	堅毅
dgA gtC	堅硬
dgA JuA	堅貞
ESI OMC	堆砌
AkB IGJ	堡壘
AkC dnC	報價
AkC ecA	報刊
AkC DuQ	報名
AkC aVD	報失
AkC hwC	報應
AkC ZHA	報時
AkC hcC	報案
AkC aNK	報稅
AkC XpA	報章
AkC XFB	報紙
AkC AiF	報表
AkC dsB	報警
AkC GkB	報道
AkC ZyA	報酬
AkC ddI	報關
AkC dcK	報館
LpA GGC	場地
LpA VJB	場所
LpA dsB	場景
LpA OGC	場次
LpA DfC	場面
LpA dcK	場館
QLC RpB	塑像
LVA hTA	塵埃
dsB GGC	境地
dsB dQC	境界
DLC GGC	墓地
DLC AFE	墓碑
DLC jgL	墓穴
DLC NqC	墓葬
DxD NuD	墨跡
DxD dsC	墨鏡
DxD gJA	墨魚
AvD iLB	壁虎
h7D XNC	壓制
h7D IwD	壓力
h7D hwX	壓抑
h7D SnC	壓榨
h7D VBD	壓縮
h7D ArD	壓迫
jkA dzA	壕溝
IGJ fyA	壘球
IDB GcJ	壟斷
UHB AsA	士兵
SpC HgA	壯年
SpC dJB	壯舉
SpC ecL	壯闊
jnC FgA	夏天
jnC dGK	夏季
RuD lpA	夕陽
gOK djA	外交
gOK cVA	外人
gOK ITA	外來
gOK dAA	外公
gOK IwD	外力
gOK fYA	外勤
gOK apA	外商
gOK dxL	外國
gOK GGC	外地
gOK jvA	外型/外形
gOK ClA	外婆
gOK CNC	外幣
gOK dQC	外界
gOK PuD	外籍
gOK AiF	外表
gOK DjC	外貌
gOK DzC	外貿
gOK NGA	外資
gOK gKC	外遇
gOK AgA	外邊
gOK QiA	外銷
gOK DfC	外面
ElA gZI	多元
ElA aiB	多少
ElA VKC	多數
ElA RoC	多謝
ElA lJA	多餘
ElA DlB	多麼
loC QiA	夜宵
loC DqD	夜幕
loC DZB	夜晚
loC VwD	夜色
loC deC	夜間
GOC VHC	大使
FgA IpC	天亮
FgA IVI	天倫
FgA GGC	天地
FgA GqA	天堂
FgA NHB	天子
FgA EMC	天帝
FgA QuC	天性
FgA hHC	天意
FgA PTA	天才
FgA DXA	天文
FgA DsA	天明
FgA ZHA	天時
FgA fiE	天橋
FgA dIA	天機
FgA hgI	天淵
FgA NTA	天災
FgA cfA	天然
FgA IHB	天理
FgA VsA	天生
FgA eAA	天空
FgA IOC	天籟
FgA XwD	天職
FgA inI	天花
FgA AKC	天賦
FgA NNC	天際
FgA FMB	天體
FgA glA	天鵝
FOC FOC	太太
FOC fwD	太極
FOC eAA	太空
FOC lpA	太陽
hpA fyA	央求
aVD XKB	失主
aVD QyA	失修
aVD IGC	失利
aVD GGC	失地
aVD bVD	失實
aVD ZpA	失常
aVD hHC	失意
aVD IfK	失戀
aVD ayB	失手
aVD DsA	失明
aVD g8D	失業
aVD DgA	失眠
aVD IMB	失禮
aVD OgD	失竊
aVD XwD	失職
aVD VwD	失色
aVD IqD	失落
aVD jrA	失衡
aVD gLC	失誤
aVD NDA	失蹤
d6D dvD	夾擊
d6D GkB	夾道
CDB DsC	奉命
CDB CSA	奉陪
NzC jjC	奏效
eMC hpD	契約
aoA YFB	奢侈
aoA DFF	奢靡
GcL ExD	奪得
GcL DBD	奪目
AXC IwD	奮力
AXC AZD	奮發
AXC EzC	奮鬥
HLA CFB	奴婢
HLA IMC	奴隸
ikB YJC	好處
DpC QpB	妄想
ELC fHC	妒忌
DiC IvA	妙齡
FlJ j5D	妥協
FlJ ZfB	妥善
FlJ F5D	妥貼
DSC DSC	妹妹
DzC XGB	姆指
aHB NLB	始祖
aHB XBA	始終
NoB DSC	姐妹
NoB NoB	姐姐
dLA LpB	姑丈
dLA MpA	姑娘
dLA QwD	姑息
dLA DzB	姑母
QuC DuQ	姓名
IkB IkB	姥姥
DLB DLB	姥姥/媽媽
IkB loA	姥爺
lGA DLB	姨媽
NGA aNC	姿勢
NGA FTC	姿態
hII QVC	威信
hII IwD	威力
hII g8A	威嚴
hPA hPA	娃娃
hfI QyC	娟秀
ClA ClA	婆婆
iaI hVA	婚姻
iaI dnC	婚嫁
iaI hgC	婚宴
iaI IMB	婚禮
iaI VnA	婚紗
DSA dQC	媒介
DSA FMB	媒體
BMC DGF	媲美
dnC SpA	嫁妝
PVD ELC	嫉妒
j5A eGC	嫌棄
j5A gHA	嫌疑
hfE jAA	嫣紅
DKB DGG	嫵媚
ZfA hfI	嬋娟
huQ jTA	嬰孩
NHB loC	子夜
NHB MJB	子女
NHB QaI	子孫
NHB dBA	子宮
eAB DiG	孔廟
eAB djC	孔教
eAB NpD	孔雀
lwC CyB	孕婦
PHC F5D	字帖
PHC DqD	字幕
PHC jvA	字形
PHC GhA	字條
PHC DzB	字母
PHC geB	字眼
PHC RHA	字詞
PHC NuD	字跡
PHC h1E	字音
PHC FMB	字體
PaI Q1A	存心
PaI EqA	存檔
PaI ecJ	存款
PaI ilK	存貨
ijC NHB	孝子
ijC dsC	孝敬
dGK ecA	季刊
dGK NgD	季節
dGK dXI	季軍
dLA PvD	孤寂
dLA GAD	孤獨
dLA I1D	孤立
jTA NHB	孩子
jTA GAA	孩童
QaI NHB	孫子
BKA inK	孵化
jED kGK	學位
jED XNC	學制
jED kXI	學員
jED DXC	學問
jED GqA	學堂
jED UHB	學士
jED NHB	學子
jED HgA	學年
jED AKB	學府
jED GLA	學徒
jED fHA	學期
jED jjC	學校
jED g8D	學業
jED IvD	學歷
jED BPC	學派
jED GAA	學童
jED R1D	學習
jED XoB	學者
jED bVL	學術
kKB LyC	宇宙
kKB jqA	宇航
hcA PfI	安全
hcA GvC	安定
hcA HvA	安寧
hcA Q1A	安心
hcA QwD	安息
hcA hIK	安慰
hcA CQA	安排
hcA BKB	安撫
hcA cfA	安然
hcA haJ	安穩
hcA JHC	安置
hcA NqC	安葬
hcA SpA	安裝
hcA lVD	安逸
hcA PuB	安靜
hcA EaK	安頓
jcI CGG	完備
jcI PfI	完全
jcI ZfB	完善
jcI ZuA	完成
jcI XuB	完整
jcI DcB	完滿
jcI AVD	完畢
jcI dgD	完結
jcI DGF	完美
jtI kIJ	宏偉
jtI lpA	宏揚
jtI gZK	宏願
NCA VGA	宗師
NCA djC	宗教
NCA PAD	宗族
NCA XGB	宗旨
dcI AsA	官兵
dcI QHA	官司
dcI IHC	官吏
dcI kXI	官員
dcI LpA	官場
dcI EMB	官邸
gFE cVA	宜人
erD ddK	客串
erD cVA	客人
erD FvA	客廳
erD dIA	客機
erD bfI	客船
erD IVI	客輪
erD kXK	客運
QfI BcC	宣判
QfI lpA	宣揚
QfI XFB	宣紙
QfI gZA	宣言
QfI ZNC	宣誓
aVD haI	室溫
jOC QyA	害羞
dnA cVA	家人
dnA DKC	家務
dnA kZI	家園
dnA dsB	家境
dnA ZDD	家屬
dnA ZpA	家常
dnA GvA	家庭
dnA PAD	家族
dnA dfO	家眷
dnA f1E	家禽
dnA dMC	家計
dnA ipA	家鄉
dnA DaA	家門
lDA eGG	容器
lDA lFC	容易
lDA H2D	容納
lDA iJB	容許
lDA DjC	容貌
QBD aoC	宿舍
PvD DqD	寂寞
PvD PuB	寂靜
dFG PaI	寄存
dFG VsA	寄生
dFG FqD	寄託
DVH OgD	密切
DVH DnB	密碼
DVH P1D	密集
AyC apA	富商
AyC kyB	富有
AyC lKC	富裕
AyC jkA	富豪
AyC dIK	富貴
jcA hHC	寒意
jcA iZI	寒暄
jcA IyA	寒流
gKC hHC	寓意
gKC VJB	寓所
dnJ CyB	寡婦
dnJ GzA	寡頭
O1B aVD	寢室
bVD INC	實例
bVD IwD	實力
bVD DKC	實務
bVD GGC	實地
bVD PuA	實情
bVD DXD	實物
bVD jgC	實現
bVD lDC	實用
bVD R1D	實習
bVD XwC	實證
bVD PfB	實踐
bVD NNC	實際
bVD g4G	實驗
bVD FMB	實體
HvA PuB	寧靜
a1B BcC	審判
a1B BMA	審批
a1B dgD	審結
a1B DGF	審美
a1B dMC	審計
a1B QVC	審訊
a1B gFG	審議
a1B lfL	審閱
QoB bVD	寫實
QoB hHC	寫意
QoB A9D	寫法
QoB XiC	寫照
QoB VsA	寫生
ecI lDA	寬容
ecI aJC	寬恕
ecI lKC	寬裕
ecI ecL	寬闊
ecI jeB	寬限
ecI CVA	寬頻
IhA hAD	寮屋
KDB hTC	寵愛
KDB DXD	寵物
AkB AkB	寶寶
AkB PlK	寶座
AkB gDD	寶玉
AkB ZuD	寶石
AkB PqC	寶藏
AkB AOC	寶貝
AkB dIK	寶貴
RHC DiG	寺廟
NpC IuB	將領
XfI cVA	專人
XfI IGC	專利
XfI XNC	專制
XfI kXI	專員
XfI dnA	專家
XfI Q1A	專心
XfI XuC	專政
XfI hcC	專案
XfI g8D	專業
XfI fGO	專櫃
XfI IcA	專欄
XfI XKC	專注
XfI luI	專營
XfI lDC	專用
XfI QfC	專線
XfI BpC	專訪
XfI StD	專責
XfI DPC	專賣
XfI P1D	專輯
XfI DaA	專門
XfI jEB	專項
NaI g8A	尊嚴
NaI UBA	尊崇
NaI dsC	尊敬
NaI dIK	尊貴
NaI LDB	尊重
R1A ZpA	尋常
R1A fyA	尋求
R1A jtL	尋獲
R1A DvD	尋覓
ESK AKC	對付
ESK IGJ	對壘
ESK gOK	對外
ESK LHB	對峙
ESK GTB	對待
ESK hwC	對應
ESK ayB	對手
ESK IyA	對流
ESK XiC	對照
ESK CrD	對白
ESK I1D	對立
ESK jRK	對話
ESK G3A	對談
ESK RpB	對象
ESK DfC	對面
GkC VGA	導師
GkC lfB	導演
GkC dcJ	導管
GkC JGC	導致
GkC gZA	導言
GkC GAD	導讀
GkC lyA	導遊
QiB KyB	小丑
QiB cVA	小人
QiB cFA	小兒
QiB B1F	小品
QiB jvA	小型
QiB NoB	小姐
QiB NHB	小子
QiB jED	小學
QiB AnA	小巴
QiB Q1A	小心
QiB ZHA	小時
QiB NLB	小組
QiB FSJ	小腿
QiB AZC	小販
QiB DtD	小麥
aiC HgA	少年
aiB VKC	少數
aiB IpC	少量
N4A dhC	尖叫
N4A EcI	尖端
PyC GGC	就地
PyC jED	就學
PyC O1B	就寢
PyC ZFB	就是
PyC g8D	就業
PyC OFB	就此
PyC QcJ	就算
PyC C9B	就範
PyC RJB	就緒
PyC GAD	就讀
PyC hHA	就醫
YuD NHB	尺子
YuD GLC	尺度
YuD DnB	尺碼
MGA dLA	尼姑
DIB AnA	尾巴
DIB auA	尾聲
HhC luD	尿液
fDD aNC	局勢
fDD jeB	局限
fDD DfC	局面
BGC dLB	屁股
dJA LKC	居住
dQC ZHA	屆時
dQC DcB	屆滿
hAD NHB	屋子
hAD kKB	屋宇
hAD NuD	屋脊
hAD EvB	屋頂
JfB kGK	展位
JfB B1F	展品
JfB fHA	展期
JfB jgC	展現
JfB I3B	展覽
JfB QiA	展銷
JfB eTA	展開
JfB ILC	展露
JfB dcK	展館
PxA OGC	層次
PxA DfC	層面
IGB IvD	履歷
ZDD QuC	屬性
VeA eyA	山丘
VeA GGC	山地
VeA BlA	山坡
VeA ZuA	山城
VeA IcI	山巒
VeA OaI	山村
VeA UnA	山楂
VeA aGJ	山水
VeA ilJ	山火
VeA ILC	山路
VeA GzA	山頭
gYD I1D	屹立
gED DzB	岳母
QVK OiC	峻峭
UBA AQC	崇拜
dqA kGK	崗位
fXL eHB	崛起
AxA jSK	崩潰
RVI IMB	巡禮
RVI lyA	巡遊
RVI IlC	巡邏
dAA cVA	工人
dAA fKC	工具
dAA PpC	工匠
dAA GGC	工地
dAA ZHA	工時
dAA g8D	工業
dAA LuA	工程
dAA gNC	工藝
dAA NGA	工資
NlB ayB	左手
NlB AgA	左邊
fJB cVA	巨人
fJB PpC	巨匠
fJB jvA	巨型
fJB QvA	巨星
fJB ecJ	巨款
fJB AfG	巨變
fJB ipB	巨響
fJB GzA	巨頭
TnA AfH	差別
TFA LFA	差池
TnA lHC	差異
TPA lHC	差異
AnA UHB	巴士
ZHB NuB	市井
ZHB dnC	市價
ZHB LpA	市場
ZHB lDA	市容
ZHB XuC	市政
ZHB DVA	市民
ZHB djA	市郊
ZHB P1D	市集
ZHB DfC	市面
EMC dxL	帝國
VGA AKC	師傅
VGA isI	師兄
VGA DSC	師妹
VGA NoB	師姐
VGA GLA	師徒
VGA C9B	師範
VGA NGA	師資
JpC CAA	帳篷
EOC GAB	帶動
EOC NHB	帶子
EOC IuB	帶領
EOC GzA	帶頭
ZpA DKC	常務
ZpA HgA	常年
ZpA FTC	常態
ZpA IHB	常理
ZpA dFI	常規
ZpA JKC	常駐
DkC NHB	帽子
jqJ NHB	幌子
DqD PpA	幕牆
CNC LHC	幣值
CNC XNC	幣制
AqA UJC	幫助
AqA DqA	幫忙
dcA ciB	干擾
dcA lJC	干預
CsA BZA	平反
HgA GTC	年代
HgA AVE	年份
HgA TJA	年初
HgA loC	年夜
HgA DIB	年尾
HgA h0C	年幼
HgA EMB	年底
HgA QwD	年息
HgA IvD	年曆
HgA dHB	年紀
HgA d1H	年級
HgA XBA	年終
HgA IkB	年老
HgA QVA	年薪
HgA AiF	年表
HgA ilK	年貨
HgA NGA	年資
HgA IVI	年輪
HgA DRC	年邁
HgA deC	年間
HgA IvA	年齡
jtB DfF	幸免
jtB ABD	幸福
jtB cHA	幸而
jtB eFM	幸虧
jtB kXK	幸運
dcC QfC	幹線
dcC IgC	幹練
jeK inK	幻化
jeK hsB	幻影
jeK QpB	幻想
jeK DfD	幻滅
jeK ExA	幻燈
jeK RpB	幻象
h0C HgA	幼年
h0C LGC	幼稚
h0C DiE	幼苗
h0A h2C	幽暗
h0A gnB	幽雅
h0A IvA	幽靈
h0A ipA	幽香
h0A DxD	幽默
dIA jLA	幾乎
AGC kyC	庇佑
AGC jLC	庇護
UpA GzA	床頭
RJB IfD	序列
RJB DqD	序幕
RJB eDD	序曲
EMB PxA	底層
EMB BgC	底片
EMB CcA	底盤
EMB QfC	底線
EMB QVA	底薪
EMB hXI	底蘊
E5C XKB	店主
E5C DfC	店面
PlK kGK	座位
PlK G3A	座談
eLC PaI	庫存
eqA FOC	康泰
QpA CpA	廂房
I4A dnC	廉價
I4A ZJC	廉署
LKA fKC	廚具
LKA VGA	廚師
LKA CpA	廚房
LKA gNC	廚藝
DiG kKB	廟宇
AUC eGC	廢棄
AUC aGJ	廢水
AUC DXD	廢物
AUC XFB	廢紙
dqJ AqD	廣博
dqJ LpA	廣場
dqJ AlC	廣播
dqJ gFG	廣義
dqJ DzC	廣袤
dqJ ecL	廣闊
FvA GqA	廳堂
dZC dxL	建國
dZC PTA	建材
dZC dzC	建構
dZC I1D	建立
dZC JBD	建築
dZC afD	建設
dZC gFG	建議
awD DIA	式微
dBA NfC	弓箭
lVB c1D	引入
lVB IwD	引力
lVB DXA	引文
lVB GLC	引渡
lVB lDC	引用
lVB AZD	引發
lVB XwC	引證
lVB eHB	引起
lVB bVL	引述
lVB FSK	引退
lVB IuB	引領
jxI lpA	弘揚
jLA jvA	弧形
cpD aNC	弱勢
cpD JFC	弱智
cpD E5B	弱點
fpA fZC	強健
fpA XNC	強制
fpA duS	強勁
fpA aNC	強勢
fpA inK	強化
fpA SpC	強壯
fpA cpD	強弱
fpA IfD	強烈
fpA GkC	強盜
fpA gtC	強硬
fpA aVA	強身
GcA jxD	彈劾
DFA ALB	彌補
hdI eDD	彎曲
hdI hiA	彎腰
jvA XNC	形制
jvA aNC	形勢
jvA lDA	形容
jvA awD	形式
jvA FTC	形態
jvA ZuA	形成
jvA UpC	形狀
jvA RpB	形象
jvA FMB	形體
OTB VwD	彩色
OTB kXI	彩雲
hsB RpB	影像
hsB hVC	影印
hsB NHB	影子
hsB JfB	影展
hsB QvA	影星
hsB BgC	影片
hsB DMA	影迷
hsB ipB	影響
AFF OFB	彼此
kpJ ITA	往來
kpJ ZpA	往常
kpJ kpJ	往往
kpJ QuD	往昔
kpJ AZB	往返
XuA XfC	征戰
XuA CBD	征服
GTB gKC	待遇
IVL VGA	律師
jzB ITA	後來
jzB iSJ	後悔
GLA CLC	徒步
GLA cfA	徒然
ExD XKB	得主
ExD lHB	得以
ExD EkC	得到
ExD aVD	得失
ExD gFE	得宜
ExD QVD	得悉
ExD hHC	得意
ExD ayB	得手
ExD huT	得益
ExD FMB	得體
CSA jSI	徘徊
ZpA lpA	徜徉
ODA lDA	從容
gJC lDC	御用
CyC AZD	復發
CBD AuT	復辟
RVI jdI	循環
DIA jvA	微型
DIA DiC	微妙
DIA QiB	微小
DIA cpD	微弱
DIA DIA	微微
DIA CBD	微服
DIA I1D	微粒
DIA CqD	微薄
ExD lBD	德育
ExD jrC	德行
iII XpA	徽章
Q1A gFE	心儀
Q1A GAB	心動
Q1A GGC	心地
Q1A dsB	心境
Q1A EMB	心底
Q1A jgA	心弦
Q1A d1H	心急
Q1A QuC	心性
Q1A PuA	心情
Q1A hHC	心意
Q1A FTC	心態
Q1A CpA	心房
Q1A AIA	心扉
Q1A JFC	心智
Q1A dIA	心機
Q1A IHB	心理
Q1A GCA	心疼
Q1A FAC	心痛
Q1A QSK	心碎
Q1A RJB	心緒
Q1A auA	心聲
Q1A LpA	心腸
Q1A ABD	心腹
Q1A igL	心血
Q1A NuD	心跡
Q1A ILC	心路
Q1A cfJ	心軟
Q1A QcI	心酸
Q1A NGK	心醉
Q1A IvA	心靈
Q1A GzA	心頭
AVD CGG	必備
AVD GvC	必定
AVD cfA	必然
AVD QKA	必需/必須
fHC ezB	忌口
fHC iIK	忌諱
cVB ZyB	忍受
cVB Q1A	忍心
cVB HTC	忍耐
XHC gZK	志願
DpC PuA	忘情
DpC glB	忘我
DpC dHC	忘記
DqA IAD	忙碌
JBA bVD	忠實
JBA IfD	忠烈
JBA ZuA	忠誠
gLC gsD	忤逆
eRK hHC	快意
eRK P4D	快捷
eRK IqD	快樂
eRK GvB	快艇
eRK QAD	快速
eRK DaA	快門
eRK OcA	快餐
H5C GzA	念頭
iaL cfA	忽然
iaL IpD	忽略
d1H ODD	急促
d1H fsD	急劇
d1H DqA	急忙
d1H QuC	急性
d1H dyC	急救
d1H IyA	急流
d1H QAD	急速
d1H QKA	急需
QuC CfH	性別
QuC PuA	性情
QuC d2B	性感
QuC UpC	性狀
dQK DXD	怪物
dQK lHC	怪異
dQK GcB	怪誕
e8D cKA	怯懦
dqI iaL	恍惚
dqI cfA	恍然
eDC BnC	恐怕
eDB fKC	恐懼
eSI jtI	恢宏
hbA ExD	恩德
hbA QFC	恩賜
G5A PuB	恬靜
dDA iHB	恭喜
dDA jlC	恭賀
OiB OiB	悄悄
OiB cfA	悄然
lfL cHB	悅耳
QVD Q1A	悉心
QDB cfA	悚然
lyA dyB	悠久
lyA lpA	悠揚
lyA cfA	悠然
lyA deA	悠閒
jdK CsC	患病
jdK XoB	患者
AGE fsD	悲劇
AGE hTA	悲哀
AGE SpC	悲壯
AGE O2B	悲慘
AGE DVF	悲憫
AGE FAC	悲痛
DaC cfD	悶熱
PuA cVA	情人
PuA aNC	情勢
PuA AkC	情報
PuA dsB	情境/情景
PuA jvA	情形
PuA hHC	情意
PuA d2B	情感
PuA FTC	情態
PuA lDD	情慾
PuA jQI	情懷
PuA GvD	情敵
PuA aJA	情書
PuA dlA	情歌
PuA ipK	情況
PuA NgD	情節
PuA dgD	情結
PuA RJB	情緒
PuA lfI	情緣
PuA gFG	情義/情誼
PuA GhC	情調
PuA gZK	情願
KyA KpC	惆悵
QuD CfH	惜別
lGI kyB	惟有
lGI GAD	惟獨
jMK dLC	惠顧
QpB RpB	想像
QpB AVD	想必
QpB A9D	想法
jqI jxL	惶惑
coB ilJ	惹火
lKA eRK	愉快
lKA lfL	愉悅
hHC DIC	意味
hHC GLA	意圖
hHC dsB	意境
hHC gOK	意外
hHC XHC	意志
hHC H5C	意念
hHC FTC	意態
hHC gFG	意義
hHC RpB	意象
hHC gZK	意願
gqD cfA	愕然
gKA IAC	愚弄
hTC cVA	愛人
hTC dxL	愛國
hTC ikC	愛好
hTC Q1A	愛心
hTC PuA	愛情
hTC DLC	愛慕
hTC IfK	愛戀
hTC ETC	愛戴
hTC jLC	愛護
e5D hHC	愜意
d2B cVA	感人
d2B EkC	感到
d2B GAB	感動
d2B ZyB	感受
d2B dcI	感官
d2B QuC	感性
d2B hbA	感恩
d2B gLC	感悟
d2B PuA	感情
d2B eTC	感慨
d2B jQI	感懷
d2B JFA	感知
d2B YDD	感觸
d2B RoC	感謝
PHA ZfB	慈善
PHA AGE	慈悲
PHA DzB	慈母
DLC DuQ	慕名
O2B fsD	慘劇
O2B ipK	慘況
O2B IfD	慘烈
O2B FAC	慘痛
O2B CrD	慘白
O2B LDB	慘重
DdC QuC	慢性
ddK ZpA	慣常
ddK QuC	慣性
QDB lDB	慫恿
esC EgB	慶典
esC jtB	慶幸
hyA Q1A	憂心
hyA jdK	憂患
hyA UyA	憂愁
hyA IJC	憂慮
hyA hXL	憂鬱
CwA eAA	憑空
PiA PGK	憔悴
iZC A9D	憲法
iZC XpA	憲章
EAB ExD	懂得
hwC AKC	應付
hwC ESK	應對
hwC d1H	應急
hwC XfC	應戰
hwC lDC	應用
hwA EqA	應當
hwC ekB	應考
hwC auA	應聲
hwC AfG	應變
cKA cpD	懦弱
LwA CZD	懲罰
IcB ExD	懶得
jQI lwC	懷孕
jQI H5C	懷念
jQI CkB	懷抱
jQI gHA	懷疑
jQI fyC	懷舊
jgI dPK	懸掛
jgI ZKA	懸殊
jgI CyA	懸浮
jgI eAA	懸空
IfK cVA	戀人
IfK PuA	戀情
IfK hTC	戀愛
dlI AvD	戈壁
ZuA djA	成交
ZuA cVA	成人
ZuA dAA	成功
ZuA DuQ	成名
ZuA kXI	成員
ZuA hVA	成因
ZuA PyC	成就
ZuA HgA	成年
ZuA jjC	成效
ZuA AaB	成本
ZuA dlJ	成果
ZuA ZBD	成熟
ZuA I1D	成立
ZuA NvD	成績
dQC CGG	戒備
dQC Q1A	戒心
dQC XGB	戒指
dQC GCD	戒毒
jxL XoB	或者
jxL iJB	或許
XfC IcK	戰亂
XfC kyB	戰友
XfC dxL	戰國
XfC LpA	戰場
XfC UHB	戰士
XfC luL	戰役
XfC dIA	戰機
XfC ilJ	戰火
XfC StA	戰爭
XfC IpD	戰略
XfC QfC	戰線
XfC NvD	戰績
XfC j7B	戰艦
XfC bVL	戰術
XfC EzC	戰鬥
VJB lHB	所以
VJB PTC	所在
VJB ZDD	所屬
VJB ExD	所得
VJB kyB	所有
VJB kIK	所謂
ayB TtD	手冊
ayB aNC	手勢
ayB dAA	手工
ayB DdD	手帕
ayB d2B	手感
ayB XGB	手指
ayB XpB	手掌
ayB LpB	手杖
ayB dIA	手機
ayB GcK	手段
ayB A9D	手法
ayB AVH	手筆
ayB RDD	手續
ayB hcK	手腕
ayB dpD	手腳
ayB AFC	手臂
ayB gNC	手藝
ayB bVL	手術
ayB GzA	手頭
PTA NHB	才子
PTA jED	才學
PTA gNC	才藝
AeC lfB	扮演
BMA XVJ	批准
BMA BcC	批判
BMA AZD	批發
ZwA AjA	承包
ZwA ZyB	承受
ZwA N4D	承接
ZwA dMC	承繼
ZwA R1D	承襲
ZwA HqD	承諾
ZwA CeC	承辦
ZwA kXK	承運
fFF dAA	技工
fFF VGA	技師
fFF A9D	技法
fFF gNC	技藝
fFF bVL	技術
TjA R1D	抄襲
AnB hED	把握
AnB gcK	把玩
AnB DaA	把門
hwX XNC	抑制
hwX jxL	抑或
hwX hXL	抑鬱
GzA AkB	投保
GzA c1D	投入
GzA dFG	投寄
GzA hsB	投影
GzA dIA	投機
GzA XKC	投注
GzA ekB	投考
GzA FTA	投胎
GzA QLC	投訴
GzA NGA	投資
GzA aVA	投身
GzA jEA	投降
eqC XfC	抗戰
eqC fVN	抗菌
BtA dvD	抨擊
EMB XNC	抵制
EMB EqC	抵擋
EMB gJB	抵禦
EMB YDD	抵觸
EMB IOC	抵賴
EMB QiA	抵銷
DcD VeD	抹煞
DcD ixD	抹黑
KyA dYA	抽筋
KyA O4A	抽籤
KyA RpB	抽象
KyA g4G	抽驗
I2D DgC	拉麵
BjA ZyC	拋售
BjA eGC	拋棄
BrD ayB	拍手
BrD AdB	拍板
BrD XiC	拍照
BrD DPC	拍賣
fJB PfL	拒絕
FlC AnB	拖把
FlC e8C	拖欠
dKA CLC	拘捕
dKA dYB	拘謹
XiA DLC	招募
XiA iLA	招呼
XiA apA	招商
XiA GTB	招待
XiA I3B	招攬
XiA NLA	招租
XiA BuS	招聘
XiA dLB	招股
XiA JGC	招致
AQC VGA	拜師
AQC FqD	拜託
XwB dyC	拯救
dDB jvA	拱形
ffM dvD	拳擊
ffM dpD	拳腳
ffM GzA	拳頭
BvA DsC	拼命
AuQ GLA	拼圖
AuQ QoB	拼寫
AuQ OzC	拼湊
AuQ CcA	拼盤
AuQ h1E	拼音
LHA dyB	持久
LHA RDD	持續
XGB H2A	指南
XGB GkC	指導
XGB N4A	指尖
XGB iII	指揮
XGB DsA	指明
XGB d7D	指甲
XGB DXA	指紋
XGB XwC	指證
XGB StD	指責
hcC h7D	按壓
hcC DlA	按摩
hcC ZHA	按時
hcC XiC	按照
hcC MyB	按鈕
GhB XfC	挑戰
FhA QfJ	挑選
HlA lDC	挪用
DZB jSI	挽回
j5D LHA	挾持
SED IAC	捉弄
lfI UJC	捐助
lfI ecJ	捐款
lfI PxC	捐贈
CLC SED	捕捉
CLC IkA	捕撈
BDB LpA	捧場
BDB ABD	捧腹
aoB eGC	捨棄
iZA eHB	掀起
QkB GGC	掃地
QkB XyB	掃帚
QkB DiE	掃描
ZyC ffM	授權
XpB Q1A	掌心
XpB hED	掌握
XpB dLC	掌故
XpB fGO	掌櫃
XpB auA	掌聲
XpB GlB	掌舵
CQA hVC	排印
CQA DuQ	排名
CQA LpA	排場
CQA gOK	排外
CQA aGJ	排水
CQA jAA	排洪
CQA lfB	排演
CQA fyA	排球
CQA IgC	排練
CQA jqC	排行
CQA daL	排骨
OTB lDC	採用
OTB drJ	採礦
OTB H2D	採納
OTB BpC	採訪
OTB dzC	採購
OTB P1D	採集
F2A R1A	探尋
F2A TwD	探測
F2A CsC	探病
F2A JFA	探知
F2A dyC	探究
F2A FkB	探討
F2A BpC	探訪
F2A i4F	探險
N4D IwD	接力
N4D ZyB	接受
N4D DXB	接吻
N4D cpB	接壤
N4D GTB	接待
N4D ayB	接手
N4D FMC	接替
N4D jtL	接獲
N4D AdA	接班
N4D dcJ	接管
N4D H2D	接納
N4D QfC	接線
N4D RDD	接續
N4D YDD	接觸
N4D XDB	接踵
N4D dGN	接軌
N4D QAC	接送
N4D IfA	接連
FSI dqJ	推廣
FSI ejA	推敲
YGI IHB	推理
YGI NgC	推薦
FSI jrA	推行
h4F jLC	掩護
DiE QoB	描寫
DiE jOK	描繪
DiE bVL	描述
T6D GLA	插圖
T6D PlK	插座
T6D ayB	插手
T6D eDD	插曲
T6D inI	插花
lpA gZA	揚言
hED ayB	握手
iII GAB	揮動
iII ayB	揮手
iII AZD	揮發
iII iqL	揮霍
kZI lVB	援引
QaJ aVD	損失
QaJ jOC	損害
QaJ iFO	損毀
QaJ huT	損益
OlA cyA	搓揉
liA GAB	搖動
liA APB	搖擺
liA jqJ	搖晃
liA I3A	搖籃
liA GzA	搖頭
EkB IcK	搗亂
EkB QSK	搗碎
F3D dZC	搭建
F3D BSC	搭配
AuS eGC	摒棄
PSI PcA	摧殘
XGC kyB	摯友
XGC hTC	摯愛
QMA IfD	撕裂
AcD ecJ	撥款
BKB hIK	撫慰
BAD exD	撲克
BAD dyC	撲救
BAD CGC	撲鼻
hDB ETC	擁戴
hDB CkB	擁抱
hDB kyB	擁有
hDB jLC	擁護
ZfC LpA	擅長
dvD FSK	擊退
OkA NqD	操作
dJC QVD	據悉
dJC E5B	據點
LED awA	擢升
gHB gFG	擬議
jqK YBA	擴充
jqK JfB	擴展
jqK dZC	擴建
APB GAB	擺動
APB afD	擺設
ciB IcK	擾亂
BdA awA	攀升
BdA CnA	攀爬
BdA G3A	攀談
jMI EOC	攜帶
jMI ayB	攜手
djB BcA	攪拌
XFA AKC	支付
XFA LHA	支持
XFA kfK	支援
XFA dnC	支架
XFA IyA	支流
XFA QfC	支線
XFA BSC	支配
XFA GSK	支隊
dTB GAB	改動
dTB ZfB	改善
dTB FgA	改天
dTB dnC	改嫁
dTB QoB	改寫
dTB dZC	改建
dTB fHA	改期
dTB XuC	改正
dTB lDC	改用
dTB NLB	改組
dTB IpA	改良
dTB AfG	改變
dTB NVC	改進
dTB GkB	改道
dTB dtD	改革
XuC DKC	政務
XuC erD	政客
XuC fDD	政局
XuC AKB	政府
XuC dTB	政改
XuC ffM	政權
XuC LHC	政治
XuC dQC	政界
XuC TtD	政策
XuC NvD	政績
XuC EqB	政黨
dLC kZI	故園
dLC dBA	故宮
dLC hHC	故意
dLC OFB	故此
dLC ipA	故鄉
dLC IHB	故里
jjC IwD	效力
jjC hwC	效應
jjC dlJ	效果
jjC A9D	效法
jjC IVL	效率
jjC lDC	效用
jjC huT	效益
DVF d2B	敏感
DVF P4D	敏捷
dyC DpA	救亡
dyC DsC	救命
dyC dxL	救國
dyC kfK	救援
dyC jLC	救護
dyC bDD	救贖
RJB bVL	敘述
djC kyB	教友
djC GqA	教堂
djC jED	教學
djC VGA	教師
djC GLA	教徒
djC ZyC	教授
djA ZyC	教授
djA aJA	教書
djC jOK	教會
djA jOK	教會
djC lBD	教育
djC lpB	教養
dsC CSC	敬佩
dsC hHC	敬意
dsC g8D	敬業
dsC hIK	敬畏
XuB dlC	整個
XuB FgA	整天
XuB dgD	整潔
XuB IHB	整理
XuB EaK	整頓
XuB FMB	整體
GvD cVA	敵人
GvD ESK	敵對
GvD hHC	敵意
GvD dXI	敵軍
BKA afD	敷設
VKC PHC	數字
VKC jED	數學
VKC IpC	數量
CNC DsC	斃命
DXA cVA	文人
DXA ffF	文件
DXA fKC	文具
DXA inK	文化
DXA kXI	文員
DXA PHC	文字
DXA jED	文學
DXA CwA	文憑
DXA DsA	文明
DXA aJA	文書
DXA AaB	文本
DXA ilJ	文火
DXA DXD	文物
DXA elI	文科
DXA XpA	文章
DXA AVH	文筆
DXA XwD	文職
DXA gNC	文藝
DXA FMB	文體
BIB cfA	斐然
AdA IeA	斑斕
AdA DXA	斑紋
AdA DnB	斑馬
AdA AED	斑駁
AdA E5B	斑點
IhA IHB	料理
X1A XpD	斟酌
YuD NGA	斥資
QVA cVA	新人
QVA jvA	新型
QVA MpA	新娘
QVA iaI	新婚
QVA HgA	新年
QVA awD	新式
QVA LiA	新潮
QVA luJ	新穎
CqA cVA	旁人
CqA FvA	旁聽
CqA XwC	旁證
CqA AgA	旁邊
IJB erD	旅客
IJB ZoB	旅社
IJB LuA	旅程
IJB aoC	旅舍
IJB aoB	旅舍
IJB lyA	旅遊
IJB dcK	旅館
PAD cVA	族人
PAD ALB	族譜
fHA dcC	旗杆
fHA j7B	旗艦
fHA CkA	旗袍
cVD dqI	日光
cVD PgA	日前
cVD AkC	日報
cVD loC	日夜
cVD NHB	日子
cVD ZpA	日常
cVD fHA	日期
cVD XiC	日照
cVD huT	日益
cVD dHC	日記
cVD OKA	日趨
cVD deC	日間
NkB hcA	早安
NkB HgA	早年
NkB cVD	早日
NkB bVA	早晨
NkB fHA	早期
NkB ZBD	早熟
NkB OcA	早餐
iDD cVD	旭日
gqA dIK	昂貴
YpA DsA	昌明
DsA IpC	明亮
DsA FgA	明天
DsA DGG	明媚
DsA HgA	明年
DsA DXA	明文
DsA cVD	明日
DsA QvA	明星
DsA JFC	明智
DsA gZL	明月
DsA IqB	明朗
DsA DfD	明滅
DsA CrD	明白
DsA eED	明確
DsA XwC	明證
DsA igB	明顯
iaI h2C	昏暗
iaI ZFK	昏睡
QuD cVD	昔日
QvA PlK	星座
QvA QvA	星星
QvA fHA	星期
QvA fyA	星球
QvA ZVA	星辰
QvA NNC	星際
hsC XiC	映照
hsC TWC	映襯
YVI FgA	春天
YVI dGK	春季
YVI cVD	春日
YVI iII	春暉
YVI OyA	春秋
YVI NgD	春節
YVI VwD	春色
PqD loC	昨夜
PqD FgA	昨天
PqD DZB	昨晚
ZFB AIA	是非
ZHA GTC	時代
ZHA exD	時刻
ZHA aNC	時勢
ZHA AkC	時報
ZHA gFE	時宜
ZHA fDD	時局
ZHA ZpA	時常
ZHA RJB	時序
ZHA fHA	時期
ZHA dIA	時機
ZHA GcK	時段
ZHA NgD	時節
ZHA cHA	時而
ZHA ZVA	時辰
ZHA XDA	時鐘
ZHA deC	時間
ZHA jeB	時限
ZHA DkA	時髦
jqJ GAB	晃動
NVC d1H	晉級
DZB hcA	晚安
DZB hgC	晚宴
DZB fHA	晚期
DZB ASC	晚輩
DZB deC	晚間
DZB jnA	晚霞
DZB OcA	晚餐
JyC loC	晝夜
bVA iFE	晨曦
BLB f1H	普及
BLB XiC	普照
BLB IlA	普羅
BLB FAA	普通
BLB AgC	普遍
dsB ipK	景況
dsB DXD	景物
dsB JGC	景致
dsB VwD	景色
dsB RpB	景象
dsB E5B	景點
NuA BgC	晶片
NuA FMB	晶體
JFC IwD	智力
JFC jMK	智慧
aJB fHA	暑期
HcJ hHC	暖意
HcJ IyA	暖流
h2C lKC	暗喻
h2C aVD	暗室
h2C IfK	暗戀
h2C PGC	暗自
KpC eRK	暢快
KpC kpK	暢旺
KpC FAA	暢通
P3C GvA	暫停
P3C ZHA	暫時
P3C jcJ	暫緩
DLC VwD	暮色
CkC kKB	暴雨
CAD ILC	暴露
IvD A9D	曆法
G2A inI	曇花
ihB ExD	曉得
ZJC dqI	曙光
eDD NHB	曲子
eDD YuD	曲尺
eDD DBD	曲目
eDD QfC	曲線
eDD gNC	曲藝
eDD GhC	曲調
aJA ecA	書刊
aJA AjA	書包
aJA QoB	書寫
aJA AaB	書本
aJA JED	書桌
aJA fGO	書櫃
aJA A9D	書法
aJA VsA	書生
aJA jPK	書畫
aJA DBD	書目
aJA PuD	書籍
aJA O4A	書籤
aJA dHC	書記
aJA DfC	書面
PxA dvA	曾經
FMC GTC	替代
FMC aVA	替身
NOK TJA	最初
NOK XBA	最終
dOK dMC	會計
gZL IpC	月亮
gZL AVE	月份
gZL ecA	月刊
gZL TJA	月初
gZL dGK	月季
gZL IvD	月曆
gZL fyA	月球
gZL GTA	月臺
gZL QVA	月薪
gZL AuR	月餅
kyB IGC	有利
kyB IwD	有力
kyB DuQ	有名
kyB jOC	有害
kyB hHC	有意
kyB jjC	有效
kyB ZHA	有時
kyB dIA	有機
kyB IHB	有理
kyB huT	有益
kyB ddI	有關
kyB jeB	有限
kyB E5B	有點
CxA kyB	朋友
CBD ZHC	服侍
CBD jvA	服刑
CBD DKC	服務
CBD lDC	服用
CBD awD	服飾
IqB RDC	朗誦
LiA GvA	朝廷
LiA lpA	朝陽
JiA lpA	朝陽
JiA jnA	朝霞
fHA GTB	期待
fHA BeC	期盼
fHA iJB	期許
fHA ilK	期貨
fHA deC	期間
fHA jeB	期限
DAD dAA	木工
DAD PTA	木材
DAD AdB	木板
DAD dnI	木瓜
DAD CZD	木筏
DAD cHB	木耳
DAD GzA	木頭
DIC ITA	未來
DIC ZpA	未嘗
DIC iaI	未婚
DIC AVD	未必
DcD GTC	末代
DcD cVD	末日
DcD fHA	末期
DcD EcI	末端
AaB cVA	本人
AaB ITA	本來
AaB IGC	本利
AaB GGC	本地
AaB NHB	本子
AaB QuC	本性
AaB QwD	本息
AaB hHC	本意
AaB elI	本科
AaB aVA	本身
AaB d1E	本金
AaB IuB	本領
AaB FMB	本體
IHB NHB	李子
jrB cVA	杏仁
OaI NHB	村子
OaI DVA	村民
OaI SpA	村莊
OaI IqD	村落
GLB dgI	杜鵑
EAA AxD	東北
EAA H2A	東南
EAA QMA	東西
RDA aJB	松鼠
AdB ExC	板凳
AdB eSK	板塊
AdB aJA	板書
I1A GGC	林地
I1A DAD	林木
I1A g8D	林業
I1A I1D	林立
dlJ cVA	果仁
dlJ kZI	果園
dlJ NHB	果子
dlJ bVD	果實
dlJ X1D	果汁
dlJ cfA	果然
dlJ CFE	果皮
dlJ GqA	果糖
dlJ cBD	果肉
dlJ NpC	果醬
XFA NgD	枝節
dnC aNC	架勢
dnC NHB	架子
dnC dzC	架構
dnC OGC	架次
dzB eHB	枸杞
ArD lyA	柏油
d3A dVL	柑橘
cyA cpD	柔弱
cyA PuA	柔情
cyA DGF	柔美
cyA cfJ	柔軟
cyA cVC	柔韌
cyA bVK	柔順
jjC kyB	校友
jjC kZI	校園
djC ESK	校對
jjC esC	校慶
jjC CBD	校服
jjC dlA	校歌
jjC aoC	校舍
jjC dFI	校規
jjC iXK	校訓
jjC JpB	校長
jtD NHB	核子
jtD Q1A	核心
jtD GgC	核電
dbA dHA	根基
dbA EMB	根底
dbA dJC	根據
dbA AaB	根本
dbA gZI	根源
dMK kfI	桂圓
dMK inI	桂花
GkA cVA	桃仁
GkA inI	桃花
epI dnC	框架
hcC ffF	案件
hcC INC	案例
hcC PuA	案情
JED NHB	桌子
dgD drB	桔梗
DSA NHB	梅子
GhA ffF	條件
GhA INC	條例
GhA ecJ	條款
GhA DnB	條碼
FMA d1H	梯級
VJA IHB	梳理
eGC ffM	棄權
eGC JHC	棄置
DfA inI	棉花
DfA hkB	棉襖
CEB fyA	棒球
dwD ayB	棘手
V1A I1A	森林
QMA QwD	棲息
loA NHB	椰子
loA X1D	椰汁
lpA IyB	楊柳
g8D XKB	業主
g8D DKC	業務
g8D dQC	業界
g8D NvD	業績
g8D lJA	業餘
fwD IwD	極力
fwD B1F	極品
fwD GGC	極地
fwD EcI	極端
fwD E5B	極點
dTC IVL	概率
SWA NHB	榛子
ksI jtB	榮幸
ksI jtL	榮獲
ksI liC	榮耀
IyA IfA	榴槤/流連
dzC dZC	構建
dzC ZuA	構成
dzC JBD	構築
IqD kZI	樂園
IqD hHC	樂意
gED eDD	樂曲
gED XpA	樂章
IqD dcI	樂觀
IzA ZHB	樓市
YKA dIA	樞機
YKA MyB	樞紐
XpA DAD	樟木
DLA BpB	模仿
DLA fKC	模具
DLA jvA	模型
DLA awD	模式
DLA gHB	模擬
DLA C9B	模範
DLA jLA	模糊
BED QLC	樸素
ZKC dcC	樹幹
ZKB I1D	樹立/豎立
d3B I3B	橄欖
fiE DfC	橋面
dIA ffF	機件
dIA XNC	機制
dIA GAB	機動
dIA eGG	機器
dIA LpA	機場
dIA jQC	機械
dIA dzC	機構
dIA NLB	機組
dIA ddI	機關
dIA GgC	機電
dIA IvA	機靈
dIA FMB	機體
RpB CFE	橡皮
EqA hcC	檔案
d4F TeD	檢察
d4F TwD	檢測
d4F luL	檢疫
d4F lfL	檢閱
d4F g4G	檢驗
d4F E5B	檢點
MrB DAA	檸檬
fGO GTA	櫃檯
htA GkA	櫻桃
ffM IGC	權利
ffM IwD	權力
ffM hII	權威
ffM gFE	權宜
ffM huT	權益
ffM bVL	權術
ffM jrA	權衡
ffM DyA	權謀
ffM dIK	權貴
OGC B1F	次品
OGC RJB	次序
OGC VKC	次數
OGC hiC	次要
OGC ilK	次貨
iYA iHB	欣喜
iYA hIK	欣慰
iYA cfA	欣然
iYA apB	欣賞
eHA h7D	欺壓
eHA SnC	欺詐
ecJ awD	款式
ecJ jEB	款項
iZD QwD	歇息
dlA fsD	歌劇
dlA YpC	歌唱
dlA GcA	歌壇
dlA ayB	歌手
dlA eDD	歌曲
dlA auA	歌聲
dlA DKB	歌舞
dlA RHA	歌詞
dlA liA	歌謠
dlA DMA	歌迷
icI iHB	歡喜
icI Q1A	歡心
icI eRK	歡快
icI lKA	歡愉
icI IqD	歡樂
icI iYA	歡欣
XHB FAC	止痛
XuC PTB	正在
XuC ikB	正好
OFB exD	此刻
OFB GGC	此地
OFB gOK	此外
CLC CZD	步伐
CLC jrA	步行
CLC UyC	步驟
DKB j5D	武俠
DKB IwD	武力
DKB dAA	武功
DKB eGG	武器
DKB UHB	武士
DKB gNC	武藝
DKB bVL	武術
QNK gZL	歲月
IvD GTC	歷代
IvD ITA	歷來
IvD VHB	歷史
IvD dQC	歷屆
IvD ZHA	歷時
IvD LuA	歷程
IvD IgC	歷練
IvD i4F	歷險
dII inK	歸化
dII ZDD	歸屬
dII H2D	歸納
QGB DpA	死亡
QGB cVA	死人
QGB jvA	死刑
QGB hVA	死因
QGB PvD	死寂
QGB XoB	死者
QGB dIJ	死鬼
QGB EqB	死黨
RVK XwD	殉職
ZKA ksI	殊榮
ZwD DVA	殖民
PcA fDD	殘局
PcA AUC	殘廢
PcA SnA	殘渣
PcA PVD	殘疾
PcA BlC	殘破
PcA eCD	殘酷
PcA lJA	殘餘
AVC I4C	殯殮
N4A DfD	殲滅
GcK IqD	段落
iFO DfD	毀滅
gIC cfA	毅然
DzB jjC	母校
DzB FMB	母體
GCD B1F	毒品
GCD DXD	毒物
GCD QLC	毒素
GCD lpD	毒藥
CGA IfA	毗連
CGA IVA	毗鄰
DkA IGC	毛利
DkA eAB	毛孔
DkA dVE	毛巾
DkA CsC	毛病
DkA CFE	毛皮
DkA AVH	毛筆
DkA AZD	毛髮
jkA exD	毫克
jkA awA	毫升
jkA DMB	毫米
DVA XKB	民主
DVA RDD	民俗
DVA AsA	民兵
DVA dxL	民國
DVA LrD	民宅
DVA Q1A	民心
DVA XuC	民政
DVA PAD	民族
DVA dlA	民歌
DVA luI	民營
DVA VsA	民生
DVA jqA	民航
DVA liA	民謠
DVA deC	民間
aGJ kGK	水位
aGJ IGC	水利
aGJ erA	水坑
aGJ kwL	水域
aGJ GqA	水塘
aGJ h7D	水壓
aGJ jLA	水壺
aGJ eLC	水庫
aGJ OTB	水彩
aGJ jdK	水患
aGJ ayB	水手
aGJ DXA	水文
aGJ NuA	水晶
aGJ dlJ	水果
aGJ LFA	水池
aGJ BjA	水泡
aGJ IyA	水流
aGJ fJA	水渠
aGJ gZI	水源
aGJ haI	水溫
aGJ PFC	水漬
aGJ IiC	水療
aGJ dcJ	水管
aGJ XDB	水腫
aGJ inI	水花
aGJ ilK	水貨
aGJ ILC	水路
aGJ GkB	水道
aGJ ipA	水鄉
aGJ gVE	水銀
aGJ IBD	水陸
aGJ DfC	水面
ksJ dyB	永久
X1D luD	汁液
fyA UJC	求助
fyA PuA	求情
fyA hTC	求愛
fyA VsA	求生
fyA JFA	求知
fyA XwD	求職
fyA XwC	求證
dEA H2A	江南
dEA VeA	江山
dEA jLA	江湖
LFA GqA	池塘
dgL EcK	決斷
eIC YoA	汽車
L1A PvD	沉寂
L1A IVI	沉淪
L1A GgC	沉澱
L1A ZFK	沉睡
L1A DMA	沉迷
L1A NGK	沉醉
L1A DxD	沉默
DAD lDD	沐浴
jlA aGJ	河水
jlA IyA	河流
jlA DnB	河馬
AIC aGJ	沸水
AIC GxA	沸騰
lyA hgA	油煙
lyA DaA	油門
lfI gcC	沿岸
lfI iTB	沿海
lfI lDC	沿用
lfI QfC	沿線
lfI ILC	沿路
lfI GLA	沿途
PfI aGJ	泉水
PfI gZI	泉源
A9D cVA	法人
A9D EgB	法典
A9D XNC	法制
A9D NxD	法則
A9D IwD	法力
A9D jED	法學
A9D dcI	法官
A9D GvC	法定
A9D VGA	法師
A9D GvA	法庭
A9D IVL	法律
A9D hcC	法案
A9D IHB	法理
A9D dHB	法紀
A9D dFI	法規
BjA OTC	泡菜
AlA GAB	波動
AlA f1H	波及
AlA GkA	波濤
XKC hHC	注意
XKC NGA	注資
XKC LDB	注重
FOC EzB	泰斗
lpA lVD	洋溢
NVA F5D	津貼
jAA aGJ	洪水
jAA IyA	洪流
j6D apA	洽商
BPC ESK	派對
BPC jMC	派系
BPC JKC	派駐
IyA DpA	流亡
IyA GAB	流動
IyA kwL	流域
IyA aVD	流失
IyA d2B	流感
IyA QvA	流星
IyA KpC	流暢
IyA DtA	流氓
IyA aGJ	流水
IyA BPC	流派
IyA IGK	流淚
IyA LuA	流程
IyA IqD	流落
IyA igL	流血
IyA FAA	流通
IyA ZNC	流逝
IyA ILC	流露
IyA FMB	流體
CyA GAB	浮動
CyA L1A	浮沉
CyA lyA	浮游
CyA jgC	浮現
lDD jEA	浴缸
iTB ezB	海口
iTB DIC	海味
iTB kXI	海員
iTB QhC	海嘯
iTB kwL	海域
iTB AkC	海報
iTB gOK	海外
iTB gcC	海岸
iTB j6D	海峽
iTB EOC	海帶
iTB aGJ	海水
iTB lpA	海洋
iTB dEB	海港
iTB LiA	海潮
iTB hdI	海灣
iTB VGA	海獅
iTB GkC	海盜
iTB DfA	海綿
iTB E3B	海膽
iTB NkB	海藻
iTB IlI	海螺
iTB GaI	海豚
iTB AjC	海豹
iTB dXI	海軍
iTB kXK	海運
iTB ddI	海關
iTB DfC	海面
iTB EhB	海鳥
iTB hzA	海鷗
N1C BjA	浸泡
N1C FzC	浸透
QiA inK	消化
QiA aVD	消失
QiA DFB	消弭
QiA QwD	消息
QiA aJB	消暑
QiA fwD	消極
QiA GCD	消毒
QiA L1A	消沉
QiA DfD	消滅
QiA VyC	消瘦
QiA FSK	消退
QiA ZNC	消逝
QiA deA	消閒
luD NuA	液晶
luD FMB	液體
I1A AnA	淋巴
I1A lDD	淋浴
I1A IFA	淋漓
OMA INC	淒厲
OMA DGF	淒美
OMA DMA	淒迷
IGK aGJ	淚水
IGK XKA	淚珠
IGK geB	淚眼
PuC LHC	淨值
PuC inK	淨化
IVI IqD	淪落
IVI j6C	淪陷
l1A hUK	淫穢
hgI AqD	淵博
hgI gZI	淵源
jaJ IcK	混亂
jaJ XfC	混戰
jaJ jjA	混淆
jaJ P2D	混雜
OfB CrD	淺白
OfB VwD	淺色
F5A dnA	添加
F5A JHC	添置
OuA h0A	清幽
OuA QVA	清新
OuA NkB	清早
OuA DsA	清明
OuA bVA	清晨
OuA TJC	清楚
OuA dgD	清潔
OuA LfD	清澈
OuA VpB	清爽
OuA IHB	清理
OuA CrD	清白
OuA CcA	清盤
OuA QcJ	清算
OuA ONK	清脆
OuA XwA	清蒸
OuA CVE	清貧
OuA gnB	清雅
OuA PuB	清靜
OuA ipA	清香
d6B h7D	減壓
d6B cpD	減弱
d6B CIA	減肥
GLC IVI	渡輪
SnA SHB	渣滓
TwD jOK	測繪
TwD IpA	測量
TwD g4G	測驗
dEB cVA	港人
dEB ezB	港口
dEB AKB	港府
lyA ksK	游泳
DiB DqA	渺茫
FcI d1H	湍急
FcI IyA	湍流
jLA CqD	湖泊
jLA CcC	湖畔
gZI IyA	源流
gZI PGC	源自
gZI GzA	源頭
IyC AwA	溜冰
dzA fJA	溝渠
dzA FAA	溝通
eMA IyA	溪流
haI hZJ	溫婉
haI aVD	溫室
haI EOC	溫帶
haI UpA	溫床
haI PuA	溫情
haI HcJ	溫暖
haI cyA	溫柔
haI PfI	溫泉
haI cVK	溫潤
haI cfD	溫熱
haI R1D	溫習
haI AjB	溫飽
haI ivA	溫馨
DfD DpA	滅亡
DfD ilJ	滅火
DfD PfL	滅絕
NHA DIC	滋味
NHA ciB	滋擾
NHA cVK	滋潤
NHA VsA	滋生
NHA ALB	滋補
daL dMA	滑稽
FkA FkA	滔滔
V1C c1D	滲入
EvD aGJ	滴水
DcB FgA	滿天
DcB PlK	滿座
DcB hHC	滿意
DcB DBD	滿目
gJA g8D	漁業
gJA bfI	漁船
OVD eGG	漆器
IzC aGJ	漏水
lfB inK	演化
lfB kXI	演員
lfB YpC	演唱
lfB NzC	演奏
lfB fFF	演技
lfB IgC	演練
lfB luD	演繹
lfB R1D	演習
lfB gNC	演藝
lfB dEB	演講
lfB AfG	演變
DqD cfA	漠然
icC NHB	漢子
icC PHC	漢字
IfA hFE	漣漪
DcC FgA	漫天
DcC CLC	漫步
DcC lyA	漫遊
dgD PuC	潔淨
dgD CrD	潔白
cVK LrD	潤澤
LiA aGJ	潮水
LiA RuD	潮汐
LiA IyA	潮流
jSK lpA	潰瘍
GgC AXB	澱粉
dvD PuA	激情
dvD gqA	激昂
dvD IyA	激流
dvD IfD	激烈
dvD AZD	激發
MDA DVH	濃密
MDA IfD	濃烈
MDA VBD	濃縮
MDA hBD	濃郁
AVA iTB	濱海
dcK XKC	灌注
ilJ dqI	火光
ilJ aNC	火勢
ilJ inK	火化
ilJ VeA	火山
ilJ QvA	火星
ilJ UPA	火柴
ilJ FcC	火炭
ilJ BjC	火炮
ilJ l4C	火焰
ilJ cfD	火熱
ilJ ILA	火爐
ilJ NfC	火箭
ilJ jAA	火紅
ilJ FSJ	火腿
ilJ bfD	火舌
ilJ inI	火花
ilJ NqC	火葬
ilJ lpD	火藥
ilJ dsB	火警
ilJ YoA	火車
ilJ QAD	火速
ilJ dlI	火鍋
ilJ dMA	火雞
iSI LVA	灰塵
iSI PVC	灰燼
iSI VwD	灰色
XpD cfD	灼熱
XpD FAC	灼痛
NTA DVA	災民
NTA jlJ	災禍
YFI fKC	炊具
k4A cfD	炎熱
TjB dnA	炒家
TjB OTC	炒菜
TjB DgC	炒麵
jgK liC	炫耀
BjC AsA	炮兵
IfD UHB	烈士
IfD cVD	烈日
IfD l4C	烈焰
hLA ixD	烏黑
IqD hVC	烙印
BDA ilJ	烽火
icB N4D	焊接
DKA IwD	無力
DKA UJC	無助
DKA ZpA	無常
DKA jvA	無形
DKA Q1A	無心
DKA lpC	無恙
DKA PuA	無情
DKA hHC	無意
DKA dLC	無故
DKA jjC	無效
DKA GvD	無敵
DKA jnC	無暇
DKA dIA	無機
DKA A9D	無法
DKA IHB	無理
DKA jnA	無瑕
DKA lHC	無異
DKA gHA	無疑
DKA huT	無益
DKA JFA	無知
DKA IMB	無禮
DKA QGA	無私
DKA fBA	無窮
DKA EcI	無端
DKA lfI	無緣
DKA IhA	無聊
DKA auA	無聲
DKA gZA	無言
DKA gLC	無誤
DKA IaI	無論
DKA kIK	無謂
DKA IOC	無賴
DKA dLA	無辜
DKA deC	無間
DKA ddI	無關
DKA jeB	無限
DKA NNC	無際
DKA QKA	無需/無須
DKA AIA	無非
NiA d1H	焦急
NiA IJC	焦慮
NiA NkC	焦躁
NiA E5B	焦點
cfA cHA	然而
hgA ilJ	煙火
hgA inI	煙花
DSA lyA	煤油
DSA FcC	煤炭
DSA drJ	煤礦
icK AZD	煥發
XiC INC	照例
XiC DsA	照明
XiC BgC	照片
XiC QpC	照相
XiC liC	照耀
XiC dLC	照顧
CZA IcK	煩亂
CZA DaC	煩悶
CZA HkB	煩惱
CZA QlJ	煩瑣
QwD DfD	熄滅
QwD ilJ	熄火
jvI DqD	熒幕
ZBD erD	熟客
ZBD QVD	熟悉
ZBD ZFK	熟睡
ZBD IqD	熟絡
ZBD IgC	熟練
ZBD R1D	熟習
gkA lpD	熬藥
cfD IwD	熱力
cfD EOC	熱帶
cfD Q1A	熱心
cfD Z1A	熱忱
cfD PuA	熱情
cfD hTC	熱愛
cfD IfD	熱烈
cfD QfC	熱線
cfD igL	熱血
cfD ZuA	熱誠
cfD aVA	熱身
cfD DaA	熱門
cfD E5B	熱點
YHC IfD	熾烈
YHC cfD	熾熱
cfA E5B	燃點
ExA dqI	燈光
ExA F3D	燈塔
hgC NHB	燕子
luI GGC	營地
luI dZC	營建
luI dyC	營救
luI g8D	營業
luI CeC	營辦
luI kXK	營運
OcC IcC	燦爛
ILA NHB	爐子
ILA ilJ	爐火
CnA VeA	爬山
StA X1D	爭執
StA GcL	爭奪
StA LHA	爭持
StA gFG	爭議
StA CfF	爭辯
StA EzC	爭鬥
kFK IhB	爲了
kFK jlA	爲何
kFI HcA	爲難
kFI ayB	爲首
NpD UHB	爵士
ClB ClB	爸爸
VpB IqB	爽朗
PpA AvD	牆壁
PpA XFB	牆紙
PpA dED	牆角
BgC exD	片刻
BgC GcK	片段
BgC DfC	片面
AdB GLA	版圖
AdB AaB	版本
AdB ffM	版權
gnA O4A	牙籤
gnA hHA	牙醫
gnA ddI	牙關
gnA YHB	牙齒
gyA ZHB	牛市
gyA CQA	牛排
gyA cBD	牛肉
DyA IGC	牟利/謀利
DzB EcA	牡丹
DBD VGA	牧師
DBD GAA	牧童
DXD ffF	物件
DXD dnC	物價
DXD IwD	物力
DXD inK	物化
DXD B1F	物品
DXD g8D	物業
DXD IyA	物流
DXD IHB	物理
DXD XDB	物種
DXD VwD	物色
DXD XwC	物證
DXD NGA	物資
DXD FMB	物體
VsA ezB	牲口
GxD dnC	特價
GxD ecA	特刊
GxD CfH	特別
GxD GGC	特地
GxD GvC	特定
GxD QoB	特寫
GxD QuC	特性
GxD jMK	特惠
GxD hHC	特意
GxD fFF	特技
GxD ffM	特權
GxD ZKA	特殊
GxD BPC	特派
GxD VwD	特色
GxD iJB	特許
GxD P1D	特輯
GxD hiA	特邀
GxD E5B	特點
QMA IGC	犀利
iFE VsA	犧牲
C9B hcC	犯案
C9B PSJ	犯罪
C9B dFI	犯規
UpC gZI	狀元
UpC FTC	狀態
UpC ipK	狀況
jLA gHA	狐疑
OJA dvD	狙擊
ayC I4D	狩獵
j6D QiB	狹小
j6D SrD	狹窄
j6D gFG	狹義
j6D hPC	狹隘
DrB IwD	猛力
DrB IfD	猛烈
DrB cfA	猛然
OTA ffM	猜拳
OaL QGB	猝死
OaL cfA	猝然
jzA NHB	猴子
VGA NHB	獅子
NpB INC	獎勵
NpB XpA	獎章
NpB apB	獎賞
NpB d1E	獎金
NpB jEB	獎項
GAD E5A	獨佔
GAD EkC	獨到
GAD IwD	獨力
GAD NzC	獨奏
GAD kyB	獨有
GAD CLC	獨步
GAD GxD	獨特
GAD CrD	獨白
GAD I1D	獨立
GAD PGC	獨自
GAD NGA	獨資
jtL XVJ	獲准
jtL IGC	獲利
jtL ExD	獲得
jtL QVD	獲悉
jtL NpB	獲獎
jtL JFA	獲知
I4D VeD	獵殺
I4D DXD	獵物
ayC hHA	獸醫
jgI dIA	玄機
jgI ddI	玄關
gDD eGG	玉器
gDD DMB	玉米
gcK fKC	玩具
BlA IFA	玻璃
QcA jLA	珊瑚
JVA B1F	珍品
JVA AkB	珍寶
JVA QuD	珍惜
JVA XKA	珍珠
JVA iIA	珍稀
JVA dIK	珍貴
XKA AkB	珠寶
AdA EMB	班底
AdA OGC	班次
AdA d1H	班級
jgC d1E	現今/現金
jgC GTC	現代
jgC LpA	現場
jgC PaI	現存
jgC bVD	現實
jgC ZHA	現時
jgC UpC	現狀
jgC RpB	現象
jgC ilK	現貨
fyA kXI	球員
fyA LpA	球場
fyA BrD	球拍
fyA QTC	球賽
fyA DMA	球迷
IHB H5C	理念
IHB QuC	理性
IHB QpB	理想
IHB JFC	理智
IHB lyA	理由
IHB elI	理科
IHB IaK	理論
IHB PTA	理財
iLB BrD	琥珀
CGA CnA	琵琶
jnA PFA	瑕疵
lKA fmA	瑜伽
VWD VBD	瑟縮
QlJ QSK	瑣碎
OSJ OcC	璀璨
jdI AkB	環保
jdI dsB	環境
jdI CkB	環抱
jdI fyA	環球
jdI NgD	環節
jdI QfC	環線
jdI lyA	環遊
dnI NHB	瓜子
dnI dlJ	瓜果
PGA eGG	瓷器
PGA CvA	瓷瓶
d3A Q1A	甘心
d3A lyA	甘油
d3A G5A	甘甜
d3A OkB	甘草
d3A XoC	甘蔗
d3A gZK	甘願
G5A B1F	甜品
G5A DGF	甜美
G5A DVD	甜蜜
G5A NyB	甜酒
G5A E5B	甜點
lDC fKC	用具
lDC IwD	用力
lDC dAA	用功
lDC B1F	用品
lDC PHC	用字
lDC Q1A	用心
lDC ZfC	用膳
lDC GLA	用途
GgA kZI	田園
GgA GGC	田地
GgA dvC	田徑
GgA IlI	田螺
d7D AdB	甲板
aVA AkC	申報
aVA QLC	申訴
aVA CeC	申辦
aVA CfF	申辯
aVA IuB	申領
H2A cVA	男人
H2A UHB	男士
H2A NHB	男子
H2A QuC	男性
H2A VsA	男生
dQC GvC	界定
dQC jeB	界限
hIK VBD	畏縮
AVD g8D	畢業
AVD VsA	畢生
AVD dsC	畢竟
lHC inK	異化
lHC DIC	異味
lHC dxL	異國
lHC GGC	異地
lHC kwL	異域
lHC ZpA	異常
lHC OTB	異彩
lHC QuC	異性
lHC DXD	異物
lHC EcI	異端
lHC gFG	異議
lHC ipA	異鄉
dFE jvA	畸型/畸形
gHA RHB	疑似
gHA DXC	疑問
gHA GcI	疑團
gHA jxL	疑惑
gHA IJC	疑慮
gHA C9B	疑犯
gHA E5B	疑點
luL PuA	疫情
luL DiE	疫苗
CFE ffO	疲倦
CFE cpD	疲弱
CFE CQC	疲憊
GCA hTC	疼愛
GCA FAC	疼痛
PVD CsC	疾病
CsC cVA	病人
CsC INC	病例
CsC hVA	病因
CsC jdK	病患
CsC PuA	病情
CsC FTC	病態
CsC IvD	病歷
CsC GCD	病毒
CsC IHB	病理
CsC AfG	病變
CsC ZNC	病逝
jbA NuD	痕跡
fuR IfI	痙攣
FAC Q1A	痛心
FAC eRK	痛快
FAC dvD	痛擊
FAC TJC	痛楚
hJC igL	瘀血
TpA lGA	瘡痍
VyC QpD	瘦削
VyC cpD	瘦弱
VyC cBD	瘦肉
gpD PVD	瘧疾
IiC A9D	療法
IiC LuA	療程
ExA LpA	登場
ExA VeA	登山
ExA dHC	登記
AZD IpC	發亮
AZD ALC	發佈
AZD QVC	發信
AZD GAB	發動
AZD ZyC	發售
AZD DXC	發問
AZD AXC	發奮
AZD JfB	發展
AZD CXB	發憤
AZD EzB	發抖
AZD lpA	發揚
AZD iII	發揮
AZD DsA	發明
AZD gZI	發源
AZD cfD	發熱
AZD jgC	發現
AZD fyA	發球
AZD VsA	發生
AZD CsC	發病
AZD lBD	發育
AZD gnA	發芽
AZD AiF	發表
AZD gZA	發言
AZD ZNC	發誓
AZD eHB	發起
AZD QAC	發送
AZD djC	發酵
AZD GgC	發電
AZD h1E	發音
CrD FgA	白天
CrD PHC	白字
CrD DiE	白描
CrD dlJ	白果
CrD PGA	白瓷
CrD VwD	白色
CrD ZJC	白薯
CrD jRK	白話
CrD NyB	白酒
CrD IuB	白領
CrD GzA	白頭
CrD AZD	白髮
ArD QuC	百姓
ArD HgA	百年
ArD ilK	百貨
EvD UHB	的士
EvD eED	的確
jqI aVD	皇室
jqI dnA	皇家
jqI EMC	皇帝
CFE PxA	皮層
CFE fyA	皮球
CFE QpA	皮箱
CFE AKA	皮膚
SyC DGE	皺眉
CaA GGC	盆地
CaA NHB	盆子
luA IGC	盈利/贏利
luA lJA	盈餘
huT JFC	益智
GkC AdB	盜版
GkC lDC	盜用
GkC OgD	盜竊
GkC PxD	盜賊
CcA DXC	盤問
CcA QcJ	盤算
CcA dJC	盤踞
DBD dqI	目光
DBD PgA	目前
DBD dvD	目擊
DBD EvD	目的
DBD QAC	目送
DrA DBD	盲目
DrA E5B	盲點
LwD dvC	直徑
LwD N4D	直接
LwD I1D	直立
LwD QfC	直線
LwD XGC	直至
LwD FAA	直通
LwD DfC	直面
QpA jLC	相互
QpA RHB	相似
QpA LfI	相傳
QpA GAA	相同
QpA hwC	相應
QpC dIA	相機
QpA AGB	相比
QpC BgC	相片
QpA CKA	相符
QpA YJB	相處
QpC DjC	相貌
QpA FAA	相通
QpA CDA	相逢
QpA IVA	相鄰
QpA IGK	相類
DGE kKB	眉宇
DGE VjA	眉梢
DGE DBD	眉目
DGE GzA	眉頭
ecA ayB	看守
S6D geB	眨眼
dfO IfK	眷戀
dfO dLC	眷顧
geB PgA	眼前
geB EMB	眼底
geB IGK	眼淚
geB fyA	眼球
geB dQC	眼界
geB CFE	眼皮
geB epI	眼眶
geB d4F	眼瞼
geB bVA	眼神
geB I4A	眼簾
geB JjC	眼罩
geB dsC	眼鏡
ZFK DgA	睡眠
ZFK GTC	睡袋
ZFK djC	睡覺
ECD TeD	督察
ECD GkC	督導
N4D DkA	睫毛
lNK JFC	睿智
idD NHB	瞎子
aVK deC	瞬間
GAA eAB	瞳孔
XDD DBD	矚目
DyA GzA	矛頭
JFA DuQ	知名
JFA dHB	知己
JFA Q1A	知心
JFA QVD	知悉
JFA PuA	知情
JFA GkB	知道
JFA h1E	知音
EcJ QVC	短信/短訊
EcJ P3C	短暫
EcJ fHA	短期
EcJ BgC	短片
EcJ QfC	短線
EcJ BjB	短跑
hPB QiB	矮小
diF fZC	矯健
ZuD RpB	石像
ZuD exD	石刻
ZuD AdB	石板
ZuD DfA	石棉
ZuD IyA	石榴
ZuD lyA	石油
ZuD iSI	石灰
ZuD AFE	石碑
ZuD eaL	石窟
ZuD dQA	石階
ZuD EhA	石雕
ZuD GzA	石頭
VnA GqA	砂糖
ggC AZD	研發
ggC dyC	研究
ggC R1D	研習
ggC XNC	研製
ggC FkB	研討
ggC GAD	研讀
J1A AdB	砧板
BlC INC	破例
BlC QaJ	破損
BlC ihB	破曉
BlC hcC	破案
BlC DfD	破滅
BlC LeC	破綻
BlC IfD	破裂
BlC DaA	破門
gtC CNC	硬幣
gtC QuC	硬性
gtC IqB	硬朗
QSK BgC	碎片
QSK ZuD	碎石
AFE DXA	碑文
AFE I1A	碑林
AFE dHC	碑記
AsD I3A	碧藍
ZuD UHB	碩士
eED AkB	確保
eED GvC	確定
eED bVD	確實
eED I1D	確立
DnB GzA	碼頭
ISJ IqD	磊落
drJ LpA	礦場
drJ dAA	礦工
drJ DXD	礦物
ZoB djA	社交
ZoB GcI	社團
fIA fyA	祈求
fIA ABD	祈福
NLB dxL	祖國
NLB NCA	祖宗
NLB DzB	祖母
NLB PuD	祖籍
bVA RHB	神似
bVA kGK	神位
bVA RpB	神像
bVA jED	神學
bVA XyA	神州
bVA DiG	神廟
bVA PuA	神情
bVA FTC	神態
bVA DsA	神明
bVA JFC	神智
bVA GAA	神童
bVA auC	神聖
bVA VwD	神色
bVA jRK	神話
bVA IvA	神靈
bVA kXK	神韻
bVA e2A	神龕
RHA GqA	祠堂
BiC dnC	票價
jlJ dbA	禍根
ABD IGC	福利
ABD KHB	福祉
IMB gFE	禮儀
IMB XNC	禮制
IMB eGG	禮器
IMB GqA	禮堂
IMB CBD	禮服
IMB DXD	禮物
IMB cpC	禮讓
IMB DjC	禮貌
IMB gKC	禮遇
f1E EhB	禽鳥
QyC DGF	秀美
QGA cVA	私人
QGA dnA	私家
QGA kyB	私有
QGA luI	私營
QGA I1D	私立
AsB ZwA	秉承
AsB LHA	秉持
OyA FgA	秋天
OyA dGK	秋季
elI jeK	科幻
elI DBD	科目
NLA lDC	租用
NLA dQC	租界
NLA M1C	租賃
NLA d1E	租金
LVD RJB	秩序
lFA djA	移交
lFA GAB	移動
lFA VGA	移師
lFA DVA	移民
iIA kyB	稀有
iIA CqD	稀薄
iIA auD	稀釋
aNK XNC	稅制
aNK DKC	稅務
aNK ecJ	稅款
aNK A9D	稅法
LuA awD	程式
VjC DIA	稍微
VjC VjC	稍稍
A1F AkC	稟報
A1F AKC	稟賦
LyA DVH	稠密
XDB NHB	種子
XDB PAD	種族
XDC ZwD	種植
GkB dAD	稻穀
GkB DMB	稻米
dAD DXD	穀物
NuD AXA	積分
haJ fZC	穩健
haJ dLC	穩固
haJ FlJ	穩妥
haJ GvC	穩定
haJ CLC	穩步
dyC dsC	究竟
eAA JBA	空中
eAC kGK	空位
eAC GGC	空地
eAA GGC	空地
eAA NoB	空姐
eAA eqK	空曠
eAC CrD	空白
eAC efL	空缺
eAA dXI	空軍
eAA kXK	空運
eAA deA	空閒
GaL dvD	突擊
GaL cfA	突然
GaL AZD	突發
GaL BlC	突破
GaL R1D	突襲
GaL AfG	突變
GaL eHB	突起
JVD QwD	窒息
fBA cVA	窮人
fBA eaK	窮困
eFI F2A	窺探
ehC DaA	竅門
I1D djA	立交
I1D exD	立刻
I1D NwD	立即
I1D LpA	立場
I1D XHC	立志
I1D ZHA	立時
I1D A9D	立法
I1D FMB	立體
J6C I1D	站立
dsC cfA	竟然
XpA LuA	章程
XpA NgD	章節
OVI dAA	竣工
GAA Q1A	童心
GAA SpA	童裝
GAA jRK	童話
GAA dXI	童軍
EcI gMA	端倪
EcI SpA	端莊
fsC fFF	競技
fsC StA	競爭
fsC QTC	競賽
fsC LBD	競逐
AVH DuQ	筆名
AVH DxD	筆墨
AVH A9D	筆法
AVH XoB	筆者
AVH YDD	筆觸
AVH dHC	筆記
ExB dnC	等價
ExB EkC	等到
ExB GAA	等同
ExB d1H	等級
dYA daL	筋骨
E2D hwC	答應
E2D hcC	答案
E2D RoC	答謝
E2D CfF	答辯
TtD GAB	策動
TtD IpD	策略
lfA RuD	筵席
dcJ XNC	管制
dcJ aDD	管束
dcJ IHB	管理
dcJ jdD	管轄
dcJ GkB	管道
NfC GzA	箭頭
QpA NHB	箱子
NgD f4F	節儉
NgD XNC	節制
NgD NzC	節奏
NgD BrD	節拍
NgD cVD	節日
NgD IyA	節流
NgD DBD	節目
NgD VsB	節省
C9B INC	範例
C9B AaB	範本
C9B LyA	範疇
BfA XpA	篇章
TdK kGK	篡位
ECD QVC	篤信
ECD GvC	篤定
OAD hDB	簇擁
OAD QVA	簇新
deB dQC	簡介
deB inK	簡化
deB AkC	簡報
deB lFC	簡易
deB IvD	簡歷
deB dgD	簡潔
deB IpD	簡略
deB LwD	簡直
deB QVC	簡訊
deB bVL	簡述
I3A AdB	籃板
I3A fyA	籃球
LyA CGG	籌備
LyA jtL	籌劃
LyA DLC	籌募
LyA OLC	籌措
LyA ecJ	籌款
LyA DnB	籌碼
LyA NGA	籌資
LyA CeC	籌辦
LyA P1D	籌集
DMB eqA	米糠
DMB QfC	米線
AXB DcD	粉末
AXB QSK	粉碎
AXB AVH	粉筆
AXB jAA	粉紅
AXB QHA	粉絲
AXB awD	粉飾
I1D NHB	粒子
PLB RDD	粗俗
PLB SpC	粗壯
PLB IpD	粗略
PLB OkC	粗糙
PLB jRK	粗話
PLB jkA	粗豪
PLB AGF	粗鄙
NuA IwD	精力
NuA DiC	精妙
NuA NHB	精子
NuA DVH	精密
NuA OTB	精彩
NuA Q1A	精心
NuA eED	精確
NuA bVA	精神
NuA QGK	精粹
NuA hsA	精英
NuA SpA	精裝
NuA CuT	精闢
NuA QFJ	精髓
jLA ezB	糊口
jLA GLA	糊塗
GqA dlJ	糖果
OkC DMB	糙米
IpA OkB	糧草
jMC FCC	系統
d0B TeD	糾察
d0B BXA	糾紛
dHB IVL	紀律
dHB H5C	紀念
jAA IGC	紅利
jAA AjA	紅包
jAA LVA	紅塵
jAA fHA	紅旗
jAA cVK	紅潤
jAA LiA	紅潮
jAA ilJ	紅火
jAA ExA	紅燈
jAA XDB	紅腫
jAA VwD	紅色
jAA GzC	紅豆
jAA dXI	紅軍
DXC IcK	紊亂
DXA IHB	紋理
DXA awD	紋飾
H2D c1D	納入
H2D aNK	納稅
H2D QGK	納粹
XFB dVE	紙巾
XFB CNC	紙幣
XFB GhA	紙條
XFB QpA	紙箱
d1H CfH	級別
BXA IcK	紛亂
BXA StA	紛爭
BXA kXI	紛紜
BXA AIA	紛飛
QLC ITA	素來
QLC PTA	素材
QLC OTC	素菜
QLC XVD	素質
NFB OTC	紫菜
QMC NxD	細則
QMC HaK	細嫩
QMC DVH	細密
QMC QiB	細小
QMC DIA	細微
QMC Q1A	細心
QMC QSK	細碎
QMC NgD	細節
QMC LGC	細緻
QMC MGC	細膩
XBA HgA	終年
XBA cVD	終日
XBA fwD	終極
XBA XHB	終止
XBA dyC	終究
XBA EcI	終端
XBA dgD	終結
XBA aVA	終身
NLB dZC	組建
NLB ZuA	組成
dgD iaI	結婚
dgD PaI	結存
dgD bVD	結實
dgD fDD	結局
dgD AQC	結拜
dgD NuA	結晶
dgD aDD	結束
dgD dlJ	結果
dgD jtD	結核
dgD hcC	結案
dgD g8D	結業
dgD dzC	結構
dgD QcJ	結算
dgD lJA	結餘
PfL IVI	絕倫
PfL ESK	絕對
PfL PuA	絕情
PfL fFF	絕技
PfL XiA	絕招
PfL VwD	絕色
PfL NuD	絕跡
IqD luD	絡繹
igK IcC	絢爛
d1H lJB	給予
FCC hVD	統一
FCC LyA	統籌
FCC dMC	統計
FCC IuB	統領
QHA jkA	絲毫
QHA dnI	絲瓜
dvA dlI	經過
NCC gNC	綜藝
IDD inK	綠化
IDD XyA	綠洲
IDD ExA	綠燈
IDD GzC	綠豆
lGI QyA	維修
lGI LHA	維持
lGI QVA	維新
lGI jLC	維護
dqA IuB	綱領
DpB kyB	網友
DpB XHB	網址
DpB fyA	網球
DpB J6C	網站
DpB IlA	網羅
DpB ILC	網路
DpB E5B	網點
dVB DVH	緊密
dVB d1H	緊急
dVB OzC	緊湊
d6A DxD	緘默
QfC ZpC	線上
QfC GhA	線條
QfC ILC	線路
lfI dLC	緣故
jcJ jvA	緩刑
jcJ d1H	緩急
jcJ DdC	緩慢
jcJ CLC	緩步
jcJ YDA	緩衝
DfB jQI	緬懷
IgC dAA	練功
IgC R1D	練習
VBD QiB	縮小
VBD hsB	縮影
VBD d6B	縮減
VBD EcJ	縮短
NDC VHB	縱使
NDA ipC	縱向
NDC PuA	縱情
NvD jjC	績效
bwA NHB	繩子
jOK XNC	繪製
dMC ZwA	繼承
dMC RDD	繼續
dMC cHA	繼而
BVA BXA	繽紛
Q4A VyC	纖瘦
Q4A QMC	纖細
Q4A lGI	纖維
PSJ cVA	罪人
PSJ DuQ	罪名
PSJ hcC	罪案
PSJ C9B	罪犯
PSJ jrC	罪行
JHC aVA	置身
CZD ecJ	罰款
IFA jdK	罹患
lpA DkA	羊毛
DGF cVA	美人
DGF gZI	美元
DGF inK	美化
DGF DIC	美味
DGF DiC	美妙
DGF jED	美學
DGF lDA	美容
DGF d2B	美感
DGF dsB	美景
DGF bVL	美術
DGF DjC	美貌
DGF NyB	美酒
IvA lpA	羚羊
QyA e8D	羞怯
QyA V1D	羞澀
QyA cDD	羞辱
gFG DKC	義務
gFG DPC	義賣
aFC CqA	翅膀
lwD HgA	翌年
lwD cVD	翌日
R1D RDD	習俗
R1D PHC	習字
R1D QuC	習性
R1D ddK	習慣
CIC OGK	翡翠
fiA TJB	翹楚
BZA QyA	翻修
BZA QVA	翻新
BZA AdB	翻版
BZA luD	翻譯
BZA aVA	翻身
BZA lfL	翻閱
IkB cVA	老人
IkB ClA	老婆
IkB NHB	老子
IkB bVD	老實
IkB VGA	老師
IkB HgA	老年
IkB awD	老式
IkB ZuA	老成
IkB iLB	老虎
IkB aJB	老鼠
ekB fYA	考勤
ekB dLB	考古
ekB LpA	考場
ekB TeD	考察
ekB IJC	考慮
ekB dJC	考據
ekB VsA	考生
ekB dyC	考究
ekB NvD	考績
ekB aHC	考試
ekB XwC	考證
ekB g4G	考驗
HTC dyB	耐久
HTC Q1A	耐心
HTC QuC	耐性
HTC cfD	耐熱
dtA GGC	耕地
dtA kXI	耕耘
cHB ElJ	耳朵
cHB dIA	耳機
cHB jdI	耳環
cHB DBD	耳目
loA QLA	耶穌
IvA QVC	聆訊
auC cVA	聖人
auC GGC	聖地
auC DzB	聖母
auC dgD	聖潔
auC aHA	聖詩
auC GcB	聖誕
BuS aJA	聘書
BuS lDC	聘用
auA DuQ	聲名
auA EOC	聲帶
auA DsA	聲明
auA gZA	聲言
auA GhC	聲調
auA h1E	聲音
auA ipB	聲響
QDB I1D	聳立
XwD kGK	職位
XwD DKC	職務
XwD kXI	職員
XwD LpA	職場
XwD dAA	職工
XwD g8D	職業
XwD ffM	職權
XwD d1H	職級
XwD StD	職責
lGC g8D	肄業
QBD DBD	肅穆
QGC hHC	肆意
QGC gpD	肆虐
cBD geB	肉眼
cBD FMB	肉體
cBD DnA	肉麻
IxD daL	肋骨
dGE cBD	肌肉
dGE AKA	肌膚
dcA k4A	肝炎
dLB AVE	股份
dLB ZHB	股市
dLB QwD	股息
dLB AaB	股本
dLB EAA	股東
dLB ffM	股權
dLB DVA	股民
XFA FMB	肢體
CIA cBD	肥肉
dgA CqA	肩膀
dgA CyB	肩負
exB GvC	肯定
BUC k4A	肺炎
kIK ezB	胃口
kIK luD	胃液
kIK k4A	胃炎
jLA GkA	胡桃
jLA NiA	胡椒
jLA f1E	胡琴
hgA XGA	胭脂
dqD BqD	胳膊
GAC FMB	胴體
CaD NHB	脖子
CKB cKB	腐乳
CKB iyB	腐朽
CKB bwD	腐蝕
HkB NHB	腦子
HkB iTB	腦海
HkB dYA	腦筋
HkB GTC	腦袋
XDB IyC	腫瘤
XDB JpC	腫脹
hiA S6B	腰斬
hiA dlJ	腰果
hiA LGI	腰椎
dpD hVC	腳印
dpD N4A	腳尖
dpD XpB	腳掌
dpD AdB	腳板
dpD CLC	腳步
dpD XHB	腳趾
dpD dbA	腳跟
dpD jnJ	腳踝
AKA OfB	膚淺
AKA VwD	膚色
E3B NHB	膽子
E3B awD	膽識
PMA EOC	臍帶
I3D LpA	臘腸
glK aVD	臥室
glK EMB	臥底
PGC XKB	自主
PGC QVC	自信
PGC QyA	自修
PGC CGG	自備
PGC XNC	自制
PGC UJC	自助
PGC GAB	自動
PGC AFA	自卑
PGC DXC	自問
PGC JjA	自嘲
PGC dnA	自家
PGC NaI	自尊
PGC dHB	自己
PGC fpA	自強
PGC IVL	自律
PGC ExD	自得
PGC glB	自我
PGC PcA	自殘
PGC VeD	自殺
PGC cfA	自然
PGC lyA	自由
PGC AZD	自發
PGC QGA	自私
PGC I1D	自立
PGC d1H	自給
PGC NgC	自薦
PGC jkA	自豪
PGC CyB	自負
PGC aVA	自身
PGC gZK	自願
XGC d1E	至今
XGC NaI	至尊
XGC aiB	至少
XGC OFB	至此
JGC IwD	致力
JGC DsC	致命
JGC AyC	致富
JGC hHC	致意
JGC dsC	致敬
JGC RoC	致謝
JGC RHA	致辭
JGC GgC	致電
fyB DLB	舅媽
fyB fyB	舅舅
dJB INC	舉例
dJB GAB	舉動
dJB AkC	舉報
dJB dnA	舉家
dJB ayB	舉手
dJB OLC	舉措
dJB XHB	舉止
dJB XwC	舉證
dJB CeC	舉辦
fyC cVD	舊日
fyC ZHA	舊時
bfD GzA	舌頭
aJA CBD	舒服
aJA jcJ	舒緩
DKB fsD	舞劇
DKB GAB	舞動
DKB NGA	舞姿
DKB eDD	舞曲
DKB CLC	舞步
DKB GTA	舞臺
DKB GkC	舞蹈
jqA OGC	航次
jqA iTB	航海
jqA AdA	航班
jqA LuA	航程
jqA eAA	航空
jqA QfC	航線
jqA kXK	航運
jqA GkB	航道
bfI kXI	船員
bfI hLB	船塢
bfI CrD	船舶
bfI XuD	船隻
j7B GSK	艦隊
IpA Q1A	良心
IpA QuC	良性
IpA dIA	良機
IpA JFA	良知
deA fJB	艱巨
deA QVA	艱辛
VwD OTB	色彩
VwD PuA	色情
VwD LrD	色澤
VwD DrA	色盲
VwD QLC	色素
ZpD lpD	芍藥
CKA lDA	芙蓉
XHA DnA	芝麻
BXA BpA	芬芳
AnA NiA	芭蕉
AnA ISJ	芭蕾
inI PAA	花叢
inI kZI	花園
inI ALC	花布
inI EcC	花旦
inI ElJ	花朵
inI NiA	花椒
inI ExA	花燈
inI CeC	花瓣
inI CvA	花瓶
inI VsA	花生
inI CrD	花白
inI CaA	花盆
inI AXB	花粉
inI jAA	花紅
inI DXA	花紋
inI VwD	花色
inI LnA	花茶
inI OkB	花草
inI ISJ	花蕾
inI DVD	花蜜
inI BIC	花費
BpA ipA	芳香
fYA OTC	芹菜
DiE GhA	苗條
jlA exD	苛刻
hsA lDB	英勇
hsA YuD	英尺
hsA BqA	英鎊
hsA kBA	英雄
DqA cfA	茫然
jSI ipA	茴香
LnA fKC	茶具
LnA dGF	茶几
LnA jLA	茶壺
LnA ASA	茶杯
LnA IzA	茶樓
LnA SpA	茶莊
LnA gNC	茶藝
LnA GkB	茶道
LnA E5B	茶點
OkB gZI	草原
OkB GLA	草圖
OkB GGC	草地
OkB CsA	草坪
OkB LpA	草場
OkB gHB	草擬
OkB aJA	草書
OkB DAD	草木
OkB dbA	草根
OkB hcC	草案
OkB CFE	草皮
OkB lpD	草藥
iqI DqD	荒漠
iqI DKA	荒蕪
jlA inI	荷花
CaD PGA	荸薺
SpA g8A	莊嚴
SpA kZI	莊園
SpA dnA	莊家
SpA dnC	莊稼
DqD DuQ	莫名
DqD AIA	莫非
dBD inI	菊花
OTC EkA	菜刀
OTC ALB	菜譜
OTC dcK	菜館
jnI fiE	華僑
DtA VsA	萌生
DtA AZD	萌發
DtA gnA	萌芽
DZC hVD	萬一
DZC PfI	萬全
DZC HgA	萬年
DZC DXD	萬物
IqD GGC	落地
IqD DqD	落寞
IqD bVD	落實
IqD ZuA	落成
IqD IGK	落淚
IqD eAA	落空
IqD AVH	落筆
IqD dpD	落腳
IqD DnB	落馬
JJC DuQ	著名
DAA ZyB	蒙受
DAA QyA	蒙羞
DAA ANC	蒙蔽
XwA AZD	蒸發
CAA CaD	蓬勃
IgA NHB	蓮子
IgA inI	蓮花
XoC GqA	蔗糖
VJA dlJ	蔬果
VJA OTC	蔬菜
CqD cpD	薄弱
CqD BgC	薄片
CqD DKC	薄霧
CqD AuR	薄餅
hOK PGK	薈萃
QVA aGJ	薪水
QVA ZyA	薪酬
QVA d1E	薪金
ZJC GhA	薯條
ZJC BgC	薯片
I3A GLA	藍圖
I3A AaB	藍本
PqA B1F	藏品
gNC cVA	藝人
gNC bVL	藝術
lpD jcI	藥丸
lpD B1F	藥品
lpD DXD	藥物
lpD lDC	藥用
lpD ZfC	藥膳
lpD OkB	藥草
hXI j2A	蘊含
CVA dlJ	蘋果
IlA CxD	蘿蔔
gpD GTB	虐待
ffE ZuA	虔誠
YJB ApA	處方
YJB hJA	處於
YJB IHB	處理
YJB JHC	處置
eFM QaJ	虧損
eFM AaB	虧本
eFM e8C	虧欠
DXA NHB	蚊子
eyA lVB	蚯蚓
XKC gnA	蛀牙
DVD gZL	蜜月
DVD GkA	蜜桃
DVD NkB	蜜棗
DVD BDA	蜜蜂
QvD luD	蜥蜴
AgA ABD	蝙蝠
jnA cVA	蝦仁
jnA DMB	蝦米
lBA c1D	融入
lBA NGA	融資
IlI QHA	螺絲
jPB jqI	蟹黃
I3D XDD	蠟燭
dLB jxL	蠱惑
igL luD	血液
igL NpA	血漿
igL dcJ	血管
igL GqA	血糖
igL FCC	血統
igL lfI	血緣
igL XGA	血脂
jrA UHC	行事
jrA cVA	行人
jqA IfD	行列
jrA GAB	行動
jqA PuA	行情
jrA XuC	行政
jrA QvA	行星
jrA IHB	行李
jqA g8D	行業
jrA kFI	行爲
jrA NzB	行走
jrA NDA	行蹤
jrA YoA	行車
jrA QiA	行銷
YDA GAB	衝動
YDA dvD	衝擊
YDA BlC	衝破
YDA GaL	衝突
AiF isI	表兄
AiF DSC	表妹
AiF NoB	表姐
AiF PxA	表層
AiF XpA	表彰
AiF PuA	表情
AiF FTC	表態
AiF lpA	表揚
AiF DsA	表明
AiF lfB	表演
AiF jgC	表現
AiF CrD	表白
AiF CFE	表皮
AiF bVL	表述
AiF ILC	表露
AiF DfC	表面
GTC aJB	袋鼠
RyC ezB	袖口
IfD jbA	裂痕
ALB YBA	補充
ALB UJC	補助
ALB B1F	補品
ALB d1H	補給
ALB R1D	補習
ALB F5D	補貼
SpA AeC	裝扮
SpA JHC	裝置
SpA afD	裝設
SpA kXK	裝運
SpA awD	裝飾
XNC CGG	製備
XNC B1F	製品
ABD P2D	複雜
QfD GAD	褻瀆
TWC V7A	襯衫
R1D dvD	襲擊
QMA AxD	西北
QMA H2A	西南
QMA dnI	西瓜
hiA fyA	要求
ByC dOC	覆蓋
dFI INC	規例
dFI NxD	規則
dFI jtL	規劃
dFI GvC	規定
dFI IVL	規律
dFI DLA	規模
dFI dKB	規矩
dFI XpA	規章
dFI C9B	規範
dGG lKA	覬覦
dcI dqI	觀光
dcI d2B	觀感
dcI DpC	觀望
dcI ecC	觀看
dcI XBC	觀衆
dED IwD	角力
dED VwD	角色
dED IqD	角落
dED LBD	角逐
YDD GAB	觸動
YDD f1H	觸及
YDD C9B	觸犯
YDD AZD	觸發
YDD GgC	觸電
gZA RHA	言辭
EvC I1D	訂立
EvC ilK	訂貨
EvC dzC	訂購
EvC d1E	訂金
dMC jtL	計劃
dMC QcJ	計算
QVC DXC	訊問
iXK IgC	訓練
dHC ExD	記得
dHC hwD	記憶
dHC RJB	記敘
dHC XoB	記者
dHC bVL	記述
gnC lHC	訝異
dgL CfH	訣別
BpC DXC	訪問
BpC erD	訪客
afD CGG	設備
afD GvC	設定
afD QpB	設想
afD A9D	設法
afD I1D	設立
afD JHC	設置
afD dMC	設計
iJB dyB	許久
iJB elB	許可
iJB ElA	許多
iJB HqD	許諾
iJB gZK	許願
CsA IaK	評論
RHA cVA	詞人
RHA EgB	詞典
RHA gFG	詞義
QVI DXC	詢問
aHC GLA	試圖
aHC F2A	試探
aHC lDC	試用
aHC g4G	試驗
aHC E5B	試點
aHA cVA	詩人
aHA GcA	詩壇
aHA hHC	詩意
aHA DXA	詩文
aHA dlA	詩歌
aHA BfA	詩篇
aHA RHA	詩詞
aHA P1D	詩集
aHA FMB	詩體
dFN lHC	詭異
OfI auD	詮釋
jRK fsD	話劇
jRK h1E	話音
dTA QGB	該死
eSI jQA	詼諧
enI liC	誇耀
ZNC RHA	誓詞
lyB hVA	誘因
lyB GkC	誘導
lyB AZD	誘發
ZuA QVC	誠信
ZuA bVD	誠實
ZuA hHC	誠意
ZuA ebB	誠懇
ZuA cfA	誠然
gLC GkC	誤導
RDC GAD	誦讀
aNK CBD	說服
elK GqA	課堂
elK AaB	課本
elK LuA	課程
elK lJA	課餘
GhA XuB	調整
GhA IHB	調理
GhA NgD	調節
GhA dPB	調解
G3A BcC	談判
G3A jRK	談話
StC kyB	諍友
jQA ipD	諧謔
jQA h1E	諧音
ABC lKC	諷喻
HqD gZA	諾言
DyA VeD	謀殺
DyA VsA	謀生
DyA IpD	謀略
DMC EMB	謎底
e5A AFA	謙卑
dEB VGA	講師
dEB PlK	講座
dEB ZyC	講授
dEB fyA	講求
dEB dyC	講究
dEB jRK	講話
dEB bVL	講述
RoC DqD	謝幕
RoC hHC	謝意
RoC RoC	謝謝
dYB dHC	謹記
XwC cVA	證人
XwC ffF	證件
XwC bVD	證實
XwC dJC	證據
XwC DsA	證明
XwC aJA	證書
XwC DXD	證物
ALB QoB	譜寫
dsB AkC	警報
dsB TeD	警察
dsB FvD	警惕
dsB ZJC	警署
dsB QVC	警訊
dsB XDA	警鐘
BFC lKC	譬喻
luD AaB	譯本
gFG dnC	議價
gFG kXI	議員
gFG RuD	議席
gFG hcC	議案
efC StD	譴責
jLC UHB	護士
jLC IHB	護理
jLC AKA	護膚
jLC QAC	護送
GAD aJA	讀書
GAD AaB	讀本
GAD A9D	讀法
GAD XoB	讀者
GAD h1E	讀音
AfG GAB	變動
AfG inK	變化
AfG NzC	變奏
AfG jeK	變幻
AfG jvA	變形
AfG Q1A	變心
AfG FTC	變態
AfG jcK	變換
AfG A9D	變法
AfG lHC	變異
AfG VwD	變色
AfG DPC	變賣
AfG OfA	變遷
AfG dtD	變革
cpC PlK	讓座
icL DfF	豁免
icL cfA	豁然
GzC NpA	豆漿
GzC CeC	豆瓣
GzC CKB	豆腐
GzC izC	豆蔻
GzC ZFC	豆豉
GzC IGK	豆類
eIB XHB	豈止
hcI GzC	豌豆
ZKB f1E	豎琴
BBA AyC	豐富
BBA cVK	豐潤
BBA ZuD	豐碩
BBA lKA	豐腴
jkA LrD	豪宅
jkA VpB	豪爽
jkA DRC	豪邁
JJA CQA	豬排
JJA cBD	豬肉
CyB jlB	負荷
CyB StD	負責
CyB DfC	負面
PTA IwD	財力
PTA DKC	財務
PTA GcI	財團
PTA AyC	財富
PTA CrD	財帛
PTA XuC	財政
PTA DXD	財物
PTA bVA	財神
CVE eaK	貧困
CVE fBA	貧窮
CVE igL	貧血
ilK B1F	貨品
ilK CNC	貨幣
ilK dnC	貨架
ilK dIA	貨機
ilK fGO	貨櫃
ilK ecJ	貨款
ilK gZI	貨源
ilK DXD	貨物
ilK J6C	貨站
ilK bfI	貨船
ilK VwD	貨色
ilK kXK	貨運
AZC GCD	販毒
AZC kXK	販運
F2A I2A	貪婪
F2A dcI	貪官
dcI YfI	貫穿
JJB PaI	貯存
dIK PAD	貴族
A4F LHC	貶值
DPB dnA	買家
DPB DPC	買賣
FTC ecJ	貸款
F5D Q1A	貼心
F5D jgC	貼現
F5D aVA	貼身
DzC luD	貿易
DzC cfA	貿然
NGA AaB	資本
NGA IvD	資歷
NGA gZI	資源
NGA QVC	資訊
NGA d1E	資金
aoA JpC	賒帳
apB dqI	賞光
apB QvD	賞析
apB awD	賞識
DPC IwD	賣力
DPC dnA	賣家
DPC PlK	賣座
DPC IAC	賣弄
DPC E5B	賣點
PfC DPC	賤賣
AKC deA	賦閒
ELB LpA	賭場
ELB GLA	賭徒
ELB XKC	賭注
IOC lHB	賴以
dzC DXD	購物
dzC JHC	購置
dzC DPB	購買
QTC BjB	賽跑
QTC DnB	賽馬
luA ExD	贏得
YuD PHC	赤字
YuD dpD	赤腳
YuD IlJ	赤裸
YuD GkB	赤道
irD cfA	赫然
eHB ITA	起來
eHB TJA	起初
eHB duS	起勁
eHB hVA	起因
eHB UpA	起床
eHB CLC	起步
eHB gZI	起源
eHB ilJ	起火
eHB DnB	起碼
eHB LuA	起程
eHB gFG	起義
eHB IqD	起落
eHB QLC	起訴
eHB aVA	起身
eHB E5B	起點
KiA cVA	超人
KiA LHC	超值
KiA PgA	超前
KiA XFA	超支
KiA ZHA	超時
KiA d1H	超級
KiA grD	超額
OKA aNC	趨勢
GgD GqC	跌宕
GgD IqD	跌落
BjB CLC	跑步
BjB DnB	跑馬
dbA PgA	跟前
dbA NVC	跟進
dbA RFI	跟隨
ILC cVA	路人
ILC NHB	路子
ILC dvC	路徑
ILC ExA	路燈
ILC LuA	路程
ILC QfC	路線
ILC dGN	路軌
ILC DfC	路面
GhA GAB	跳動
GhA AdB	跳板
GhA bwA	跳繩
GhA DKB	跳舞
GhA NkB	跳蚤
GhA lpD	跳躍
GqD CLC	踱步
NDA hsB	蹤影
lpD awA	躍升
aVA AVE	身份
aVA dnC	身價
aVA NHB	身子
aVA lwC	身孕
aVA jvA	身形
aVA hsB	身影
aVA Q1A	身心
aVA PTA	身材
aVA GcK	身段
aVA eKA	身軀
aVA AgA	身邊
aVA FMB	身體
eKA dcC	軀幹
eKA FMB	軀體
YoA BiC	車票
YoA GkB	車道
YoA GSK	車隊
dGN NuD	軌跡
dGN GkB	軌道
dXI cVA	軍人
dXI GcI	軍團
dXI dcI	軍官
dXI DVA	軍民
dXI luI	軍營
dXI j7B	軍艦
dXI CZD	軍閥
dXI GSK	軍隊
cfJ daL	軟骨
LBD Q1A	軸心
CKB NlC	輔佐
CKB UJC	輔助
CKB GkC	輔導
CKB CNC	輔幣
iII hsC	輝映
iII jqI	輝煌
IVI eqL	輪廓
IVI IyA	輪流
IVI AdA	輪班
IVI FTA	輪胎
IVI bfI	輪船
aKA luA	輸贏
aKC QAC	輸送
JfJ jvA	轉型
JfJ jcK	轉換
JfJ JpC	轉賬
JfJ PTC	轉載
JfJ kXK	轉運
QVA fYA	辛勤
QVA QcI	辛酸
CeC jED	辦學
CeC A9D	辦法
CeC IHB	辦理
RHA XwD	辭職
RHA NkB	辭藻
CgB NHB	辮子
CfF XwC	辯證
CfF jLC	辯護
CfF AED	辯駁
HCA fKC	農具
HCA GGC	農地
HCA LpA	農場
HCA IvD	農曆
HCA OaI	農村
HCA g8D	農業
HCA DVA	農民
HCA GgA	農田
HCA SpA	農莊
HCA lpD	農藥
hKA CKB	迂腐
hKA jSI	迂迴
iYD d1E	迄今
QVC QAD	迅速
AZB jSI	返回
AZB LiA	返潮
jvJ cfA	迥然
ArD jOC	迫害
DMA IcK	迷亂
DMA cVA	迷人
DMA QVC	迷信
DMA dBA	迷宮
DMA DpB	迷惘
DMA IfK	迷戀
DMA jLA	迷糊
DMA DqA	迷茫
DMA ILC	迷路
AtC AZD	迸發
JGI R1A	追尋
JGI hwD	追憶
JGI CLC	追捕
JGI BDB	追捧
JGI dvD	追擊
JGI fyA	追求
JGI dyC	追究
JGI NDA	追蹤
JGI LBD	追逐
JGI RFI	追隨
FSK iyA	退休
FSK inK	退化
FSK jSI	退回
FSK jED	退學
FSK RuD	退席
FSK luL	退役
FSK ecJ	退款
FSK cfD	退熱
FSK VBD	退縮
FSK cpC	退讓
QAC CfH	送別
GkA DpA	逃亡
GkA DsC	逃命
GkA C9B	逃犯
GkA BjB	逃跑
GkA CFC	逃避
gsD dsB	逆境
QiA liA	逍遙
FzC dsC	透鏡
FzC ILC	透露
LBD HgA	逐年
LBD CLC	逐步
GLA cVA	途人
GLA dvC	途徑
XoB QoA	這些
XoB dlC	這個
XoB IHB	這裏
XoB DlB	這麼
FAA RDD	通俗
FAA QVC	通信/通訊
FAA AkC	通報
FAA QiA	通宵
FAA ZpA	通常
FAA KpC	通暢
FAA ihB	通曉
FAA lDC	通用
FAA JFA	通知
FAA jAA	通紅
FAA O1D	通緝
FAA JpC	通脹
FAA jRK	通話
FAA ilK	通貨
FAA FzC	通透
FAA GkB	通道
FAA ddI	通關
FAA GgC	通電
OkC BpC	造訪
IfA ddK	連串
IfA GAA	連同
IfA loC	連夜
IfA EOC	連帶
IfA DqA	連忙
IfA N4D	連接
IfA jdI	連環
IfA dgD	連結
IfA RDD	連續
IfA DNC	連袂
IfA d1E	連襟
IfA QlJ	連鎖
NVC ITA	進來
NVC c1D	進入
NVC inK	進化
NVC ezB	進口
NVC JfB	進展
NVC GLC	進度
NVC CLC	進步
NVC AZD	進發
NVC LuA	進程
NVC cHA	進而
NVC jrA	進行
NVC dAC	進貢
NVC dXI	進軍
NVC JKC	進駐
lKA fHA	逾期
lyA cVA	遊人
lyA jED	遊學
lyA erD	遊客
lyA IvD	遊歷
lyA gcK	遊玩
lyA GvB	遊艇
lyA dHC	遊記
lyA aNK	遊說
lyA IVI	遊輪
kXK GAB	運動
kXK jlA	運河
kXK luI	運營
kXK lDC	運用
kXK QcJ	運算
kXK LyA	運籌
kXK PTC	運載
kXK aKC	運輸
kXK QAC	運送
AgC f1H	遍及
AgC GGC	遍地
dlK eJC	過去
dlK OqD	過錯
hcD XNC	遏制
hcD hwX	遏抑
hcD XHB	遏止
jnA QpB	遐想
jnA cFB	遐邇
GkB fKC	道具
GkB UHB	道士
GkB dnA	道家
GkB ExD	道德
GkB IHB	道理
GkB gFG	道義
GkB CkA	道袍
GkB dcK	道觀
GkB RoC	道謝
GkB ILC	道路
kII INC	違例
kII A9D	違法
kII dFI	違規
QaK VwD	遜色
gkA lyA	遨遊
NkA ZyB	遭受
NkA gKC	遭遇
XoA h4F	遮掩
XoA EqC	遮擋
XoA ANC	遮蔽
LGA EkC	遲到
LGA NkB	遲早
LGA jcJ	遲緩
LGA GaK	遲鈍
NVI RVI	遵循
OfA PyC	遷就
OfA QFB	遷徙
OfA lFA	遷移
IhA ecL	遼闊
CFC DfF	避免
CFC fHC	避忌
CFC aJB	避暑
CFC HcC	避難
DRC NVC	邁進
jPC jzC	邂逅
AgA dsB	邊境
AgA dQC	邊界
AgA dpA	邊疆
AgA lfI	邊緣
AgA ZFI	邊陲
AgA NNC	邊際
IlC P1D	邏輯
RoA hqD	邪惡
djA gOK	郊外
djA lyA	郊遊
CzB ZJC	部署
CLB GSK	部隊
kyA ffF	郵件
kyA AjA	郵包
kyA B1F	郵品
kyA fDD	郵局
kyA XuC	郵政
kyA QpA	郵箱
kyA IVI	郵輪
kyA GMC	郵遞
ELA ZHB	都市
ipA OaI	鄉村
ipA h1E	鄉音
IVA aoB	鄰舍
XpD PuA	酌情
BSC ffF	配件
BSC CGG	配備
BSC ZyC	配售
BSC ESK	配對
BSC d1H	配給
BSC JHC	配置
BSC lpD	配藥
BSC XNC	配製
BSC dED	配角
BSC h1E	配音
BSC grD	配額
BSC awD	配飾
NyB dnA	酒家
NyB E5C	酒店
NyB ASA	酒杯
NyB IzA	酒樓
NyB NuA	酒精
NyB dcK	酒館
QLA ONK	酥脆
ZyA d1E	酬金
eCD jvA	酷刑
eCD hTC	酷愛
eCD aJB	酷暑
eCD cfD	酷熱
QcI QuC	酸性
QcI FAC	酸痛
NGK cVA	醉人
NGK Q1A	醉心
YyB IzC	醜陋
hHA jED	醫學
hHA VGA	醫師
hHA IiC	醫療
hHA lpD	醫藥
hHA jLC	醫護
MpC NyB	釀酒
auD cfA	釋然
IHB LuA	里程
LDA QVA	重新
LDA NLB	重組
LDA CyC	重複
LDB hiC	重要
LDB ZGC	重視
LDB IpC	重量
LDB E5B	重點
d1E dqA	金剛
d1E NHB	金子
d1E drJ	金礦
d1E CqD	金箔
d1E VwD	金色
d1E lBA	金融
d1E grD	金額
d1E awD	金飾
d1E jqI	金黃
EhC gJA	釣魚
IvA auA	鈴聲
lfI AVH	鉛筆
gVE gZI	銀元
gVE DqD	銀幕
gVE jrB	銀杏
gVE jlA	銀河
gVE VwD	銀色
gVE jqA	銀行
GAA RpB	銅像
GAA eGG	銅器
DvA DXA	銘文
QiA ZyC	銷售
dJC YHB	鋸齒
dqA f1E	鋼琴
dqA dYA	鋼筋
dqA FgD	鋼鐵
d1F HqA	錦囊
d1F IHB	錦鯉
OqD IcK	錯亂
OqD gLC	錯誤
dlI AnA	鍋巴
EcK IgC	鍛鍊
XDA PuA	鍾情
XDA hTC	鍾愛
etA OpA	鏗鏘
dsC NHB	鏡子
dsC BgC	鏡片
dsC GzA	鏡頭
XDA IzA	鐘樓
XDA GzA	鐘頭
FgD AdB	鐵板
FgD IcA	鐵欄
FgD ILC	鐵路
lpD ZFA	鑰匙
DaA ezB	門口
DaA ZHB	門市
DaA GLA	門徒
DaA epI	門框
DaA DGE	門楣
DaA j7B	門檻
DaA GMC	門第
DaA ILC	門路
DaA IvA	門鈴
eTA ezB	開口
eTA LpA	開場
eTA ebB	開墾
eTA aHB	開始
eTA JfB	開展
eTA DqD	開幕
eTA GvA	開庭
eTA Q1A	開心
eTA jQI	開懷
eTA OTB	開採
eTA XFA	開支
eTA IqB	開朗
eTA g8D	開業
eTA aGJ	開水
eTA lfB	開演
eTA AZD	開發
eTA CcA	開盤
eTA ehC	開竅
eTA EcI	開端
eTA eEA	開腔
eTA inI	開花
eTA afD	開設
eTA QTC	開賽
eTA CeC	開辦
eTA FAA	開通
eTA QiA	開銷
eTA IlA	開鑼
eTA DaA	開門
eTA ecL	開闊
eTA ddI	開關
eTA CuT	開闢
eTA GzA	開頭
deA jnC	閒暇
deA G3A	閒談
deC jxL	間或
deC N4D	間接
deC iZD	間歇
deC G5D	間諜
deC dtD	間隔
dqD IzA	閣樓
lfL IvD	閱歷
lfL I3B	閱覽
lfL GAD	閱讀
ecL CfH	闊別
ecL YpD	闊綽
ddI jLA	關乎
ddI dMC	關係
ddI NHB	關子
ddI Q1A	關心
ddI hTC	關愛
ddI jQI	關懷
ddI XKC	關注
ddI aNK	關稅
ddI NgD	關節
ddI IfA	關連
ddI DaA	關門
YfB DsA	闡明
YfB bVL	闡述
YfB auD	闡釋
SJB IwD	阻力
SJB gTC	阻礙
SJB dtD	阻隔
hlA lGA	阿姨
CKC ffF	附件
CKC dnA	附加
CKC LpD	附着
CKC afD	附設
CKC fYB	附近
IzC R1D	陋習
DrD VsA	陌生
DrD ILC	陌路
dEC IqD	降落
jeB dnC	限價
jeB XNC	限制
jeB fHA	限期
EzB OiC	陡峭
kfK jjC	院校
LVC GGC	陣地
LVC lDA	陣容
CSA GAA	陪同
CSA NqC	陪葬
CSA TWC	陪襯
h1E hsB	陰影
h1E QuC	陰性
h1E IvD	陰曆
h1E L1A	陰沉
h1E DyA	陰謀
h1E lpA	陰陽
h1E i4F	陰險
IwA kZI	陵園
IwA DLC	陵墓
j6C c1D	陷入
j6C PuB	陷阱
IBD GGC	陸地
IBD RDD	陸續
IBD ILC	陸路
IBD dXI	陸軍
lpA QcB	陽傘
lpA dqI	陽光
lpA dqA	陽剛
lpA QuC	陽性
lpA IvD	陽曆
lpA GTA	陽臺
GSK gLB	隊伍
GSK kyB	隊友
dQA PxA	階層
dQA FMA	階梯
dQA GcK	階段
dQA d1H	階級
dtD AvD	隔壁
dtD loC	隔夜
dtD h1E	隔音
RGK GkB	隧道
RFI NwD	隨即
RFI hHC	隨意
RFI ZHA	隨時
RFI aVA	隨身
i4F QVK	險峻
IMC aJA	隸書
NpD AdA	雀斑
NpD lpD	雀躍
kBA kIJ	雄偉
kBA fZC	雄健
kBA Q1A	雄心
kBA QuC	雄性
kBA dJC	雄踞
gnB JGC	雅致
P1D JBA	集中
P1D GcI	集團
P1D ZHB	集市
P1D dgD	集結
P1D iXK	集訓
P1D NGA	集資
P1D FMB	集體
PfJ ksJ	雋永
OFA QuC	雌性
EhA RpB	雕像
EhA exD	雕刻
EhA QLC	雕塑
EhA JED	雕琢
EhA awD	雕飾
QGI cfA	雖然
VEA ipC	雙向
VEA luA	雙贏
VEA AgA	雙邊
UKA jvA	雛形
P2D IcK	雜亂
P2D DKC	雜務
P2D fFF	雜技
P2D DXD	雜物
P2D XHC	雜誌
P2D ilK	雜貨
dMA cBD	雞肉
dMA IxD	雞肋
QfL IGA	雪梨
QfL CrD	雪白
QfL inI	雪花
kXI PxA	雲層
kXI FMA	雲梯
kXI P1D	雲集
ISI GAA	雷同
GgC QVC	電信/電訊
GgC IwD	電力
GgC GAB	電動
GgC eGG	電器
GgC AkC	電報
GgC h7D	電壓
GgC NHB	電子
GgC hsB	電影
GgC FMA	電梯
GgC LFA	電池
GgC AlA	電波
GgC IyA	電流
GgC gZI	電源
GgC ExA	電燈
GgC DpB	電網
GgC QfC	電線
GgC I3C	電纜
GgC HkB	電腦
GgC GTA	電臺
GgC jRK	電話
GgC ILC	電路
GgC IvA	電鈴
GgC SJB	電阻
QKA fyA	需求
XVC GAB	震動
XVC X4D	震懾
XVC j2B	震撼
XVC dsA	震驚
iqL IcK	霍亂
iqL cfA	霍然
VpA inI	霜花
ILC FgA	露天
ILC aGJ	露水
ILC luI	露營
ILC GTA	露臺
ILC daL	露骨
AnC XKB	霸主
IvA kGK	靈位
IvA dqI	靈光
IvA QuC	靈性
IvA d2B	靈感
IvA DVF	靈敏
IvA dIA	靈機
IvA XHA	靈芝
IvA g4G	靈驗
PuB FTC	靜態
PuB XHB	靜止
PuB GgC	靜電
AIA C9A	非凡
AIA ZpA	非常
AIA A9D	非法
DfC LHC	面值
DfC fKC	面具
DfC PgA	面前
DfC eAB	面孔
DfC DBD	面目
DfC QpC	面相
DfC VnA	面紗
DfC JjC	面罩
DfC VwD	面色
DfC aHC	面試
DfC G3A	面談
DfC DjC	面貌
DfC d5D	面頰
DfC grD	面額
FgB FgB	靦腆
dtD DsC	革命
dtD QVA	革新
dtD XwD	革職
dDB dLC	鞏固
AfA NHB	鞭子
AfA BjC	鞭炮
cVC EOC	韌帶
dyB OTC	韭菜
h1E gED	音樂
h1E CKA	音符
h1E NgD	音節
h1E VwD	音色
h1E dQA	音階
h1E kXK	音韻
h1E ipB	音響
kXK DIC	韻味
kXK IVL	韻律
ipB hwC	響應
ipB auA	響聲
EvB IzA	頂樓
EvB EcI	頂端
EvB d1H	頂級
EvB E5B	頂點
jEB DBD	項目
bVK IGC	順利
bVK aNC	順勢
bVK dsB	順境
bVK RJB	順序
bVK hwC	順應
bVK ayB	順手
bVK KpC	順暢
bVK GkB	順道
lJC CGG	預備
lJC AkC	預報
lJC GvC	預定
lJC d2B	預感
lJC fHA	預期
lJC TwD	預測
lJC elI	預科
lJC QcJ	預算
lJC R1D	預習
lJC gZA	預言
lJC dMC	預計
lJC DyA	預謀
lJC dsB	預警
gdI IfL	頑劣
gdI fpA	頑強
gdI PVD	頑疾
EaK ZHA	頓時
IuB kwL	領域
IuB GkC	領導
IuB EOC	領帶
IuB gLC	領悟
IuB IpD	領略
IuB jqA	領航
IuB RyC	領袖
IuB dXI	領軍
IuB GSK	領隊
GzA kXK	頭暈
GzA GhA	頭條
GzA GCA	頭疼
GzA FAC	頭痛
GzA CFE	頭皮
GzA ExB	頭等
GzA RJB	頭緒
GzA HkB	頭腦
GzA j7A	頭銜
GzA EvB	頭頂
GzA AZD	頭髮
CVA IVL	頻率
CVA GkB	頻道
elJ I1D	顆粒
grD gOK	額外
grD GzA	額頭
gdA VwD	顏色
gZK hHC	願意
IGK RHB	類似
IGK CfH	類別
IGK jvA	類型
dLC f1H	顧及
dLC DXC	顧問
dLC erD	顧客
dLC fHC	顧忌
dLC IJC	顧慮
XfC GAB	顫動
XfC EzB	顫抖
igB ExD	顯得
igB cfA	顯然
igB jgC	顯現
igB geB	顯眼
igB irD	顯赫
igB ILC	顯露
AIA FgA	飛天
AIA eRK	飛快
AIA lpA	飛揚
AIA dIA	飛機
AIA RpA	飛翔
AIA DKB	飛舞
AIA bfI	飛船
AIA lpD	飛躍
AIA EhB	飛鳥
dGE glC	飢餓
AjB ZyB	飽受
AjB jED	飽學
AjB DcB	飽滿
AjB I3B	飽覽
awD B1F	飾品
awD lfB	飾演
awD DXD	飾物
OcA fKC	餐具
OcA dVE	餐巾
OcA FvA	餐廳
OcA JED	餐桌
OcA dcK	餐館
OcA E5B	餐點
lJA dqI	餘光
lJA GGC	餘地
lJA kXK	餘韻
lJA grD	餘額
jaI GaI	餛飩
DcA GzA	饅頭
fGO PxC	饋贈
ipA DIC	香味
ipA AVA	香檳
ipA aGJ	香水
ipA ilJ	香火
ipA ILA	香爐
ipA BgC	香片
ipA G5A	香甜
ipA OkB	香草
ipA NiA	香蕉
ipA ZVI	香醇
DnB BVD	馬匹
DnB bVL	馬術
DnB ILC	馬路
DnB YoA	馬車
LFA DuQ	馳名
LFA KuB	馳騁
RVI CBD	馴服
AED jSI	駁回
AED YuD	駁斥
JKC dXI	駐軍
dnC gJC	駕馭
dnC VHB	駕駛
jQB erD	駭客
IqD GlA	駱駝
NVK DnB	駿馬
GxA AIA	騰飛
QkA IcK	騷亂
QkA GAB	騷動
QkA ciB	騷擾
DrD GGC	驀地
DrD cfA	驀然
diE cVA	驕人
diE gkC	驕傲
g4G XwC	驗證
dsA cVA	驚人
dsA iLA	驚呼
dsA iHB	驚喜
dsA jqI	驚惶
dsA gqD	驚愕
dsA lHC	驚異
dsA gnC	驚訝
dsA i4F	驚險
UyC cfA	驟然
daL dcC	骨幹
daL dnC	骨架
daL iSI	骨灰
daL IAD	骨碌
daL elI	骨科
daL GzA	骨頭
daL drD	骨骼
daL QFJ	骨髓
jQA daL	骸骨
FMB XNC	體制
FMB IwD	體力
FMB DIC	體味
FMB jvA	體型/體形
FMB TeD	體察
FMB cpD	體弱
FMB QVL	體恤
FMB FTC	體態
FMB luD	體液
FMB haI	體溫
FMB jgC	體現
FMB jMC	體系
FMB lBD	體育
FMB g4G	體驗
dkA jjC	高校
AZD jvA	髮型
AZD awD	髮式
EzC StA	鬥爭
EzC gyA	鬥牛
hXL dgD	鬱結
dIJ NHB	鬼子
dIJ dQK	鬼怪
dIJ DGG	鬼魅
DGG IwD	魅力
DGG jxL	魅惑
DlA IwD	魔力
DlA jeK	魔幻
DlA A9D	魔法
DlA bVL	魔術
gJA jEA	魚缸
gJA aFC	魚翅
gJA cHC	魚餌
gJA IVA	魚鱗
CjB gJA	鮑魚
IHB gJA	鯉魚
VnA gJA	鯊魚
EhB e3C	鳥瞰
CBC IGA	鳳梨
hnA BgC	鴉片
hZI hpA	鴛鴦
d2D NHB	鴿子
glA dcA	鵝肝
htA DKB	鸚鵡
j6A gJA	鹹魚
IAD cDA	鹿茸
fHA IVA	麒麟
DgC AjA	麵包
DgC AXB	麵粉
DnA CZA	麻煩
DnA XVB	麻疹
DnA NGK	麻醉
jqI iaI	黃昏
jqI VwD	黃色
jqI GzC	黃豆
jqI d1E	黃金
IMA DsA	黎明
IMA DVA	黎民
M4A luD	黏液
ixD cVA	黑人
ixD loC	黑夜
ixD h2C	黑暗
ixD AdB	黑板
ixD CrD	黑白
ixD DnB	黑馬
DxD hTA	默哀
DxD QoB	默寫
DxD aJA	默書
DxD cfA	默然
DxD iJB	默許
DxD DxD	默默
h0B ixD	黝黑
E5B Q1A	點心
E5B dvD	點擊
E5B EvD	點滴
E5B cfA	點燃
E5B fyA	點球
E5B GzA	點頭
EqB kXI	黨員
EqB eSI	黨魁
h6B cfA	黯然
EvB IwD	鼎力
CGC NHB	鼻子
CGC eAB	鼻孔
IDA NuB	龍井
IDA XyA	龍舟
IDA jnA	龍蝦
IDA DaA	龍門
IDA GzA	龍頭
IDA CBC	龍鳳
hVD jnB NHB	一下子
hVD ezB eIC	一口氣
hVD eSK cFA	一塊兒
hVD jOK cFA	一會兒
hVD GhA IDA	一條龍
hVD ASC NHB	一輩子
hVD E5B cFA	一點兒
Q3A dED jvA	三角形
JBA jED VsA	中學生
XKB cVA dAA	主人公
XKB LHA cVA	主持人
cGC IyA NHB	二流子
hnC cfD EOC	亞熱帶
djA luD VJB	交易所
djA luD grD	交易額
cVA PuA DIC	人情味
cVA DVA CNC	人民幣
GTC IHB cVA	代理人
GTC gZA cVA	代言人
djB djB XoB	佼佼者
AkB XwC d1E	保證金
AkB IvA fyA	保齡球
QVC lDC XwC	信用證
GvA dIA CsA	停機坪
LfI djC UHB	傳教士
gZI QiA NgD	元宵節
DfF luL IwD	免疫力
PfI ApA kGK	全方位
PfI cVD XNC	全日制
PfI fyA inK	全球化
AeD dlA cFA	八哥兒
dAA DKC kXI	公務員
dAA awD inK	公式化
dAA kyB XNC	公有制
dAA huT d1E	公益金
dAA XwC cVA	公證人
dAA eTA QVC	公開信
dAA eTA QTC	公開賽
AxD fwD kBA	北極熊
Z1D PHC dnC	十字架
AcC GkC FMB	半導體
j5D NzC eDD	協奏曲
AqD DXD dcK	博物館
hVC AiF dIA	印表機
ezB ABA f1E	口風琴
ezB ipA GqA	口香糖
dhC inK NHB	叫化子
dVD RpA DXD	吉祥物
GAA QuC IfK	同性戀
iLA i1H GkB	呼吸道
JfD jED dnA	哲學家
ZyC ilK kXI	售貨員
dxL DKC esA	國務卿
dxL NNC inK	國際化
kfI DKB eDD	圓舞曲
GLA aJA dcK	圖書館
GGC FgD J6C	地鐵站
dHA AaB dAA	基本功
dHA AaB A9D	基本法
dHA ECD djC	基督教
h7D QNK PfA	壓歲錢
gOK dxL cVA	外國人
gOK QvA cVA	外星人
gOK NLB DzB	外祖母
ElA gZI inK	多元化
ElA DSA FMB	多媒體
FgA XKB djC	天主教
FgA inI AdB	天花板
FOC fwD ffM	太極拳
FOC eAA cVA	太空人
FOC lpA jMC	太陽系
NzC DsA eDD	奏鳴曲
PHC F5D cFA	字帖兒
kKB jqA kXI	宇航員
hcA PfI EOC	安全帶
hcA PfI d2B	安全感
hcA QwD cVD	安息日
hcA DgA lpD	安眠藥
dnA ZpA OTC	家常菜
QoB PHC IzA	寫字樓
XfI IGC ffM	專利權
ESK dEB dIA	對講機
QiB jTA cFA	小孩兒
QiB jED VsA	小學生
QiB CxA kyB	小朋友
JfB I3B dcK	展覽館
dAA apA g8D	工商業
dAA g8D inK	工業化
dAA LuA VGA	工程師
HgA GzA cFA	年頭兒
jeK ExA BgC	幻燈片
h0C LGC kZI	幼稚園
dZC JBD VGA	建築師
dZC JBD DXD	建築物
hsB hVC dIA	影印機
IVL XuC QHA	律政司
DIA VsA DXD	微生物
Q1A IHB jED	心理學
AVD QKA B1F	必需品
OiB OiB jRK	悄悄話
PuA cVA NgD	情人節
QpB RpB IwD	想像力
DdC lyA lyA	慢悠悠
IcB lpA lpA	懶洋洋
ZuA kXI dxL	成員國
ZuA HgA cVA	成年人
dQC GCD VJB	戒毒所
VJB kyB XNC	所有制
ayB dAA gNC	手工藝
BMA AZD dnC	批發價
fFF bVL kXI	技術員
eqC lpD QuC	抗藥性
FlC I2D dIA	拖拉機
XGB iII dnA	指揮家
lpA auA eGG	揚聲器
jqK h1E eGG	擴音器
APB dnC NHB	擺架子
DXA SyC SyC	文縐縐
AdA DnB QfC	斑馬線
cVD dqI lDD	日光浴
cVD dqI ExA	日光燈
BLB FAA A9D	普通法
BLB FAA jRK	普通話
CkC ABA kKB	暴風雨
CBD DKC kXI	服務員
dbA dJC GGC	根據地
dIA eGG cVA	機器人
dIA jQC inK	機械化
d4F TeD dcI	檢察官
MrB DAA LnA	檸檬茶
fGO kXI dIA	櫃員機
dlA YpC dnA	歌唱家
XHB FAC lpD	止痛藥
IvD VHB QuC	歷史性
ZwD DVA GGC	殖民地
AVC gFE dcK	殯儀館
aGJ IDA GzA	水龍頭
iTB gcC QfC	海岸線
jaJ cVD NHB	混日子
OuA DsA NgD	清明節
iSI DAA DAA	灰蒙蒙
hLA IDA LnA	烏龍茶
DKA DuQ XGB	無名指
DKA VJB kIK	無所謂
DKA QfC GgC	無線電
DKA inI dlJ	無花果
gnA XyA CsC	牙周病
GAD DAD XyA	獨木舟
GAD dED ayC	獨角獸
jgC GTC inK	現代化
d7D daL DXA	甲骨文
H2A NHB icC	男子漢
H2A jTA cFA	男孩兒
CsC gZI FMB	病原體
AZD GAB dIA	發動機
AZD JfB apA	發展商
AZD gZI GGC	發源地
AZD IkA QkA	發牢騷
AZD RpA GGC	發祥地
AZD gZA cVA	發言人
AZD gZA ffM	發言權
AZD GgC dIA	發電機
CrD DAD cHB	白木耳
CrD cfD inK	白熱化
CrD CFE aJA	白皮書
CrD DqA DqA	白茫茫
CrD IcA GGC	白蘭地
CrD igL fyA	白血球
CrD igL CsC	白血病
CrD jRK DXA	白話文
DBD EvD GGC	目的地
LwD awA dIA	直升機
LwD IyC IyC	直溜溜
geB XKA NHB	眼珠子
ggC dyC kXI	研究員
BlC FgA iqI	破天荒
drJ PfI aGJ	礦泉水
QGA kyB inK	私有化
elI jED dnA	科學家
EcI gLB NgD	端午節
fsC StA IwD	競爭力
AVH dHC AaB	筆記本
NuA bVA CsC	精神病
GqA HhC CsC	糖尿病
dHB H5C B1F	紀念品
dHB H5C cVD	紀念日
dHB H5C AFE	紀念碑
dHB H5C dcK	紀念館
jAA igL fyA	紅血球
H2D DaC cFA	納悶兒
NFB gOK QfC	紫外線
XBA EcI dIA	終端機
lGI FlA DsC	維他命
dMC ZwA cVA	繼承人
dMC ZwA ffM	繼承權
Q4A lGI QLC	纖維素
IkB cVA dnA	老人家
IkB FOC FOC	老太太
IkB HgA cVA	老年人
IkB ArD QuC	老百姓
IkB GzA cFA	老頭兒
IkB GzA NHB	老頭子
ekB dLB jED	考古學
IhA FgA cFA	聊天兒
XwD g8D CsC	職業病
jLA NiA AXB	胡椒粉
jLA IlA CxD	胡蘿蔔
E3B dLC ZVI	膽固醇
PGC QVC Q1A	自信心
PGC UJC OcA	自助餐
PGC GAB inK	自動化
PGC cfA dQC	自然界
PGC jrA YoA	自行車
jqA iTB dnA	航海家
XHA DnA NpC	芝麻醬
AnA ISJ DKB	芭蕾舞
I3A LyA dLB	藍籌股
gNC bVL B1F	藝術品
gNC bVL dnA	藝術家
igL kyB CsC	血友病
igL QiB AdB	血小板
igL I1A I1A	血淋淋
dFI C9B inK	規範化
afD dMC VGA	設計師
iJB elB XwC	許可證
aHC lDC fHA	試用期
aHC d1E ZuD	試金石
GAD aJA cVA	讀書人
AfG GgC J6C	變電站
GzC CKB cKB	豆腐乳
CyB StD cVA	負責人
DPC ddI NHB	賣關子
eHB QLC aJA	起訴書
CKB GkC kXI	輔導員
CeC dAA aVD	辦公室
CfF jLC cVA	辯護人
GvD UHB MGA	迪士尼
FSK iyA d1E	退休金
FAA Q1A AXB	通心粉
NVC ezB apA	進口商
kXK GAB kXI	運動員
kXK GAB LpA	運動場
kXK GAB CBD	運動服
QcI IyC IyC	酸溜溜
YyB AeD dQK	醜八怪
IHB LuA AFE	里程碑
d1E PHC F3D	金字塔
dqA f1E dnA	鋼琴家
eTA LpA CrD	開場白
eTA Q1A dlJ	開心果
eTA AZD apA	開發商
CKC dnA LHC	附加值
CSA a1B kXI	陪審員
CSA a1B GcI	陪審團
P1D SpA QpA	集裝箱
dMA DIB NyB	雞尾酒
GgC NHB f1E	電子琴
GgC hsB NgD	電影節
GgC eIC inK	電氣化
GgC jRK QfC	電話線
PuB OiB OiB	靜悄悄
EvB dLA dLA	頂呱呱
igB DIA dsC	顯微鏡
DnB I2D RDA	馬拉松
FMB haI dMC	體溫計
AZD jvA VGA	髮型師
dIJ DaA ddI	鬼門關
DlA bVL VGA	魔術師
gJA NHB NpC	魚子醬
DtD gnA GqA	麥芽糖
DnA NGK lpD	麻醉藥
hVD IkA ksJ lVD	一勞永逸
hVD iLA ArD hwC	一呼百應
hVD C9A ABA bVK	一帆風順
hVD QpA PuA gZK	一廂情願
hVD QkB cHA eAA	一掃而空
hVD cVD OgA IHB	一日千里
hVD JiA hVD RuD	一朝一夕
hVD XFA GAD QyC	一枝獨秀
hVD OuA cGC TJC	一清二楚
hVD DKA VJB kyB	一無所有
hVD DBD IhB cfA	一目了然
hVD dJB IpB ExD	一舉兩得
hVD dgC cJA dLC	一見如故
hVD YDD NwD AZD	一觸即發
hVD GzA DKC aGJ	一頭霧水
IcK OVD AeD NkA	亂七八糟
gLB inI AeD DaA	五花八門
NuB NuB kyB GhA	井井有條
luD CLC luD OKA	亦步亦趨
cVA ffH GGC IvA	人傑地靈
cVA VeA cVA iTB	人山人海
RHB ZFB cHA AIA	似是而非
AKB Z1D dQA ZFB	俯拾皆是
dnC I4A DXD DGF	價廉物美
c1D ipA RFI RDD	入鄉隨俗
PfI IwD lHB BKC	全力以赴
PfI Q1A PfI hHC	全心全意
NTC N4D NTC INC	再接再厲
C9A AKA RDD NHB	凡夫俗子
CfH kyB lDC Q1A	別有用心
exD daL DvA Q1A	刻骨銘心
PgA VJB DIC kyB	前所未有
lDB kpJ LwD PgA	勇往直前
Z1D PfI Z1D DGF	十全十美
OgA TpA ArD eAB	千瘡百孔
OgA BfA hVD IVL	千篇一律
OgA QHA DZC IKB	千絲萬縷
AcC QVC AcC gHA	半信半疑
JED kyB ZuA jjC	卓有成效
H2A kZI AxD LfD	南轅北轍
ezB JKA AVH CZD	口誅筆伐
dLB VwD dLB ipA	古色古香
VHB DKA PgA INC	史無前例
dqD PyC dqD kGK	各就各位
GAA Q1A j5D IwD	同心協力
DuQ PaI bVD DpA	名存實亡
FlK ayB elB ExD	唾手可得
DXC Q1A DKA dGO	問心無愧
iHB eIC lpA lpA	喜氣洋洋
hVA GGC XNC gFE	因地制宜
GGC GAB VeA liA	地動山搖
ElA UyA ZfB d2B	多愁善感
ElA PTA ElA gNC	多才多藝
ElA OFB hVD dJB	多此一舉
FgA H2A GGC AxD	天南地北
FgA iqI GGC IkB	天荒地老
h4F h4F hVD QwD	奄奄一息
PHC XuC eEA kfI	字正腔圓
jED lHB JGC lDC	學以致用
bVD XGC DuQ dII	實至名歸
a1B ZHA GqD aNC	審時度勢
VeA OuA aGJ QyC	山清水秀
jvA jvA VwD VwD	形形色色
AVE AVE kyB IMB	彬彬有禮
GLA IkA DKA dAA	徒勞無功
ExD Q1A hwC ayB	得心應手
ExD hHC DpC jvA	得意忘形
RVI RVI ZfB lyB	循循善誘
RVI dFI GkC dKB	循規蹈矩
Q1A eqK bVA lHA	心曠神怡
Q1A kyB lJA fGK	心有餘悸
cVB DKA elB cVB	忍無可忍
BtA cfA Q1A GAB	怦然心動
AGE FgA DVF cVA	悲天憫人
hwC kXK cHA VsA	應運而生
ayB DKB NDD GkC	手舞足蹈
ayB NDD DKA OLC	手足無措
hwX lpA EaK NlK	抑揚頓挫
BrD hcC dhC PfL	拍案叫絕
awD DBD lHB GTB	拭目以待
XGB cVD elB GTB	指日可待
hcC CLB PyC AdA	按部就班
dJC IHB IwD StA	據理力爭
LuD GGC kyB auA	擲地有聲
cVD QVA gZL lHC	日新月異
DsA JFA dLC C9B	明知故犯
KpC VJB lDD gZA	暢所欲言
G2A inI hVD jgC	曇花一現
kyB AdB kyB geB	有板有眼
kyB auA kyB VwD	有聲有色
hhB DKA cVA hgA	杳無人煙
iKB iKB cJA VsA	栩栩如生
iYA iYA ipC ksI	欣欣向榮
iZD QFA EMB IHB	歇斯底里
aGJ EkC fJA ZuA	水到渠成
O1C cVA Q1A CFA	沁人心脾
L1A DxD dnJ gZA	沉默寡言
NVA NVA kyB DIC	津津有味
iTB ecL FgA eAA	海闊天空
haI DXA cFB gnB	溫文爾雅
iSI AIA hgA DfD	灰飛煙滅
DKA dPC elB dvD	無懈可擊
DKA dKA DKA aDD	無拘無束
DKA ZHA DKA exD	無時無刻
DKA ddI FAC lpB	無關痛癢
icK cfA hVD QVA	煥然一新
cfA DGE XHA d1H	燃眉之急
GAD hVD DKA cGC	獨一無二
I1A IqA DcB DBD	琳瑯滿目
lHC ezB GAA auA	異口同聲
lHC dXI GaL eHB	異軍突起
AZD CXB GLA fpA	發憤圖強
ArD DKA IhA IOC	百無聊賴
aVK QwD DZC AfG	瞬息萬變
JFA dHB JFA AFF	知己知彼
GaL AIA DrB NVC	突飛猛進
NuA huT fyA NuA	精益求精
XFB NGK d1E DMA	紙醉金迷
BXA XGC G2D ITA	紛至沓來
PfL DKA fVG kyB	絕無僅有
YpD YpD kyB lJA	綽綽有餘
dMC kpJ eTA ITA	繼往開來
BfA BfA eHB DKB	翩翩起舞
cHB DBD hVD QVA	耳目一新
auC GcB IkB cVA	聖誕老人
QBD cfA eHB dsC	肅然起敬
QGC DKA fHC GcC	肆無忌憚
jLA IlA CxD QLC	胡蘿蔔素
dpD F2D bVD GGC	腳踏實地
PGC P3A jvA hUK	自慚形穢
PGC eHA eHA cVA	自欺欺人
DZC DKA hVD aVD	萬無一失
DZC NFB OgA jAA	萬紫千紅
YVJ YVJ lDD GAB	蠢蠢欲動
YDD DBD dsA Q1A	觸目驚心
HqD AOC cFB NpB	諾貝爾獎
AfG AaB dnA INC	變本加厲
apB Q1A lfL DBD	賞心悅目
lpD lpD lDD aHC	躍躍欲試
kXK LyA kGI hED	運籌帷幄
liA liA DKA fHA	遙遙無期
d1E AsD iII jqI	金碧輝煌
eTA NCA DsA gFG	開宗明義
dtD imI QkA lpB	隔靴搔癢
RFI Q1A VJB lDD	隨心所欲
RFI ZHA RFI GGC	隨時隨地
RFI AlA LBD IyA	隨波逐流
XVC cHB lDD IAA	震耳欲聾
bVK IHB ZuA XpA	順理成章
GzA iaI HkB JpC	頭昏腦脹
GzA BlC igL IyA	頭破血流
GzA GzA ZFB GkB	頭頭是道
AIA f1E NzB ayC	飛禽走獸
dIJ AKB bVA dAA	鬼斧神工
h6B cfA aVD VwD	黯然失色
